title	artist
Growing Pains	Alessia Cara
Best Life	Cardi B Featuring Chance The Rapper
Trust	Justin Bieber
Hot Shower	Chance The Rapper Featuring MadeinTYO & DaBaby
We Own It (Fast & Furious)	2 Chainz & Wiz Khalifa
She Won’t Be Lonely Long	Clay Walker
I Hold On	Dierks Bentley
Body and Soul	Tony Bennett & Amy Winehouse
You	Jacquees
Waiting For Superman	Daughtry
NUMB	XXXTENTACION
Same Love	Macklemore & Ryan Lewis Featuring Mary Lambert
Cheerleader	OMI
The House That Built Me	Miranda Lambert
7/11	Beyonce
Wavin’ Flag	K'Naan
Yuck!	2 Chainz Featuring Lil Wayne
BAD!	XXXTENTACION
Play It Again	Luke Bryan
U With Me?	Drake
No Hands	Waka Flocka Flame Featuring Roscoe Dash & Wale
Gangnam Style	PSY
One in a Million	Ne-Yo
Marvin’s Room	Drake
Get On Your Knees	Nicki Minaj Featuring Ariana Grande
Centuries	Fall Out Boy
Monster	Paramore
No Stylist	French Montana Featuring Drake
I’m a Mess	Bebe Rexha
Heartbeat	Carrie Underwood
Saint-Tropez	Post Malone
Mirror	Lil Wayne Featuring Bruno Mars
Break My Bank	New Boyz Featuring Iyaz
Only Prettier	Miranda Lambert
Party	Chris Brown Featuring Usher & Gucci Mane
Springsteen	Eric Church
The Way	Ariana Grande Featuring Mac Miller
LUST.	Kendrick Lamar
Broken Halos	Chris Stapleton
Tempo	Chris Brown
This Ain’t No Love Song	Trace Adkins
My Man	Glee Cast
Lie	NF
Blame	Calvin Harris Featuring John Newman
Good as Hell	Lizzo
We Are The World 25 For Haiti	Artists For Haiti
Feds Watching	2 Chainz Featuring Pharrell
Type Of Way	Rich Homie Quan
Sober Saturday Night	Chris Young Featuring Vince Gill
Games	Luke Bryan
FRIENDS	Marshmello & Anne-Marie
One Man Band	Old Dominion
Why Ya Wanna	Jana Kramer
You’re Mine (Eternal)	Mariah Carey
White Liar	Miranda Lambert
All to Myself	Dan + Shay
It Ain’t My Fault	Brothers Osborne
Let It Sing	Kevin Gates
(If You’re Wondering If I Want You to) I Want You To	Weezer
Sorry	Justin Bieber
The Middle	Zedd, Maren Morris & Grey
I Could Use a Love Song	Maren Morris
Call Out My Name	The Weeknd
Hello	Glee Cast Featuring Jonathan Groff
Say Something	Justin Timberlake Featuring Chris Stapleton
For the First Time	The Script
I Am	Mary J. Blige
Take Back the Night	Justin Timberlake
Feelin’ It	Scotty McCreery
More	Usher
Ain’t My Fault	Zara Larsson
Galway Girl	Ed Sheeran
Kiss You	One Direction
10 Freaky Girls	Metro Boomin Featuring 21 Savage
Mercy	Shawn Mendes
Boo’d Up	Ella Mai
What Now	Rihanna
If Heaven Wasn’t So Far Away	Justin Moore
This Is What You Came For	Calvin Harris Featuring Rihanna
Automatic	Miranda Lambert
BROWN SKIN GIRL	Beyonce, SAINt JHN & Wizkid Featuring Blue Ivy Carter
Sweatshirt	Jacob Sartorius
Scholarships	Drake & Future
Celebrate	DJ Khaled Featuring Travis Scott & Post Malone
Money Longer	Lil Uzi Vert
This Is America	Childish Gambino
H.O.L.Y.	Florida Georgia Line
Side Effects	The Chainsmokers Featuring Emily Warren
Soldier of Love	Sade
Photograph	J. Cole
I Will Always Love You	Glee Cast
Shark in the Water	V V Brown
Just Us	DJ Khaled Featuring SZA
Night Shift	Jon Pardi
Patty Cake	Kodak Black
Nothing	The Script
Every Time I Hear That Song	Blake Shelton
Madness	Muse
Hideaway	Kiesza
Face My Fears	Hikaru Utada & Skrillex
If You Only Knew	Shinedown
Moment 4 Life	Nicki Minaj Featuring Drake
I Don’t Want This Night to End	Luke Bryan
Walk Thru	Rich Homie Quan Featuring Problem
Temporary Home	Carrie Underwood
Eastside	benny blanco, Halsey & Khalid
Did It for the Girl	Greg Bates
Let It Rain	David Nail Featuring Sarah Buxton
Mona Lisa	Lil Wayne Featuring Kendrick Lamar
Mine	Taylor Swift
Huntin’, Fishin’ & Lovin’ Every Day	Luke Bryan
No Shopping	French Montana Featuring Drake
Only Human	Jonas Brothers
Bartier Cardi	Cardi B Featuring 21 Savage
Perfume	Britney Spears
Post Malone - rockstar ft. 21 Savage (Türkçe Çeviri)	Post Malone Featuring 21 Savage
Sit Still, Look Pretty	Daya
Sun Daze	Florida Georgia Line
​beibs in the trap	Travis Scott
Bad Habits (Uncut)	Maxwell
Finally Found You	Enrique Iglesias Featuring Sammy Adams
Little White Church	Little Big Town
Wrong Baby Wrong Baby Wrong	Martina McBride
Booty	Blac Youngsta
A Sky Full of Stars	Coldplay
LA CANCIÓN	J Balvin & Bad Bunny
I Luh Ya Papi	Jennifer Lopez Featuring French Montana
Helluva Night	Ludacris
Lose My Mind	Young Jeezy Featuring Plies
NEW MAGIC WAND	Tyler, The Creator
Moves	Big Sean
VIBEZ	DaBaby
Renegades	X Ambassadors
ZEZE	Kodak Black Featuring Travis Scott & Offset
Middle	DJ Snake Featuring Bipolar Sunshine
Remember You	Wiz Khalifa Featuring The Weeknd
No Money	Galantis
Miss Movin’ On	Fifth Harmony
Tongue Tied	Grouplove
Digital Dash	Drake & Future
Troublemaker	Olly Murs Featuring Flo Rida
Honey Bee	Blake Shelton
I’m Comin’ Over	Chris Young
If I Had You	Adam Lambert
Can’t Be Friends	Trey Songz
Deja Vu	Post Malone Featuring Justin Bieber
Sippin’ on Fire	Florida Georgia Line
I Will Wait	Mumford & Sons
History	One Direction
Love Somebody	Maroon 5
TiK ToK	Ke$ha
​can’t leave without it	21 Savage
Fall For Your Type	Jamie Foxx Featuring Drake
All Eyes on You	Meek Mill Featuring Chris Brown & Nicki Minaj
Jar of Hearts	Christina Perri
Hallelujah	Pentatonix
Last Hurrah	Bebe Rexha
Cruise (Remix)	Florida Georgia Line Featuring Nelly
Stay	Rihanna Featuring Mikky Ekko
It Don’t Hurt Like It Used To	Billy Currington
Numb	Usher
One Foot	WALK THE MOON
Beautiful People	Chris Brown Featuring Benny Benassi
Super Bass	Nicki Minaj
Regret In Your Tears	Nicki Minaj
Startender	A Boogie Wit da Hoodie Featuring Offset & Tyga
Stuck Like Glue	Sugarland
2018 haywoodindahood Listening Log	Christopher Wilde & Anna Margaret
Praying	Kesha
Black Rain	Soundgarden
Let Her Go	Passenger
The Edge of Glory	Lady Gaga
Moonlight	XXXTENTACION
Promise	Romeo Santos Featuring Usher
Sure Thing	Miguel
Sleeping with a Friend	Neon Trees
Juice	Lizzo
Ayo	Chris Brown & Tyga
Drive By	Train
Chanel (Go Get It)	Young Thug Featuring Gunna & Lil Baby
I Got You	Thompson Square
Hood Go Crazy	Tech N9Ne Featuring 2 Chainz & B.o.B
That’s What I Like	Bruno Mars
Love Me Like You Mean It	Kelsea Ballerini
Somebody	Bridgit Mendler
No	Meghan Trainor
Begin Again	Taylor Swift
Whispers in the Dark	Mumford & Sons
Bully	Shinedown
For The First Time	Darius Rucker
In Your Arms	Nico & Vinz
Sorry	Beyonce
Pound the Alarm	Nicki Minaj
Bad Romance	Glee Cast
From The Ground Up	Dan + Shay
Let Me Love You	DJ Snake Featuring Justin Bieber
Mama’s Song	Carrie Underwood
Mary Did You Know	Jordan Smith
Gonna Know We Were Here	Jason Aldean
Confident	Demi Lovato
Better Than I Used To Be	Tim McGraw
We Run the Night (RedOne Remix)	Havana Brown Featuring Pitbull
Dessert	Dawin
King Kunta	Kendrick Lamar
Blurred Lines	Robin Thicke Featuring T.I. + Pharrell
Take Back Home Girl	Chris Lane Featuring Tori Kelly
Maybe	Sick Puppies
The Box	Roddy Ricch
One Day	Matisyahu
Yellow Flicker Beat	Lorde
Don’t Judge Me	Chris Brown
When I Was Your Man	Bruno Mars
The Walker	Fitz And The Tantrums
Lay It Down	Lloyd
Make Me...	Britney Spears Featuring G-Eazy
American Country Love Song	Jake Owen
Sexy and I Know It	LMFAO
Drew Barrymore	Bryce Vine
Home	Machine Gun Kelly, X Ambassadors & Bebe Rexha
No Such Thing as a Broken Heart	Old Dominion
On My Level	Wiz Khalifa Featuring Too $hort
Marry Me	Thomas Rhett
Wanted	Hunter Hayes
Ordinary Girl	Hannah Montana
Season 2 Episode 2: “Sexual Harassment”	Michael Jackson Duet With Akon
Drummer Boy	Justin Bieber Featuring Busta Rhymes
PILLOWTALK	Zayn
Please Me	Cardi B & Bruno Mars
All Gold Everything	Trinidad James
I Really Like You	Carly Rae Jepsen
The Adventures of Rain Dance Maggie	Red Hot Chili Peppers
​Oui	Jeremih
Jump Right In	Zac Brown Band
Backin’ It Up	Pardison Fontaine Featuring Cardi B
Believer	Imagine Dragons
Worth It	YK Osiris
When I’m Gone	Wiz Khalifa
Scars to Your Beautiful	Alessia Cara
Bang Bang	Jessie J, Ariana Grande & Nicki Minaj
As Long As You Love Me	Justin Bieber Featuring Big Sean
Once an Addict (Interlude)	J. Cole
Timeless	A Boogie Wit da Hoodie Featuring DJ SPINKING
Let It Go	Idina Menzel
Let’s Go Crazy	Prince And The Revolution
What About Us	P!nk
2018 haywoodindahood Listening Log	Gucci Mane X Bruno Mars X Kodak Black
What If I Never Get Over You	Lady Antebellum
Judas	Lady Gaga
Stereo Hearts	Gym Class Heroes Featuring Adam Levine
Wildfire	John Mayer
Rock	Plies
Carter Son	YoungBoy Never Broke Again
This Town	Niall Horan
Here’s to Never Growing Up	Avril Lavigne
The Night We Met	Lord Huron
Home Alone Tonight	Luke Bryan Featuring Karen Fairchild
Hot Boy	Bobby Shmurda
Body Party	Ciara
Motivation	Normani
(Kissed You) Goodnight	Gloriana
Good Good Night	Roscoe Dash
SLOW DANCING IN THE DARK	Joji
F.N	Lil Tjay
Twerk	City Girls Featuring Cardi B
It Will Rain	Bruno Mars
Small Town Throwdown	Brantley Gilbert Featuring Justin Moore & Thomas Rhett
Boyfriend	Ariana Grande & Social House
Hold Up	Beyonce
Fix a Drink	Chris Janson
​the light is coming	Ariana Grande Featuring Nicki Minaj
Bounce Back	Big Sean
Bad Romance	Lady Gaga
I’ll Show You	Justin Bieber
Forget You	Glee Cast Featuring Gwyneth Paltrow
Everybody’s Got Somebody But Me (Encore)	Hunter Hayes Featuring Jason Mraz
Locked Away	R. City Featuring Adam Levine
Wish I Didn’t Love You	Chloe Kohanski
Up All Night	Blink-182
Back Up	DeJ Loaf Featuring Big Sean
Rack City	Tyga
All Time Low	Jon Bellion
Post Malone - Goodbyes ft. Young Thug (Traducción al Español)	Post Malone Featuring Young Thug
Rap Saved Me	21 Savage, Offset & Metro Boomin Featuring Quavo
Perfect	Ed Sheeran
Señorita	Shawn Mendes & Camila Cabello
Burn the House Down	AJR
Nonstop	Drake
Wasted Love	Matt McAndrew
KOODA	6ix9ine
Foreign	Trey Songz
​lovely	Billie Eilish & Khalid
River Bank	Brad Paisley
Ain’t Worried About Nothin’	French Montana
Bugatti	Ace Hood Featuring Future & Rick Ross
Kiss it Better	Rihanna
Radio	Darius Rucker
Can’t Help Falling in Love (The Voice Performance)	Christina Grimmie
Chillin’ It	Cole Swindell
Neighbors	J. Cole
Hide Away	Daya
Home	One Direction
I Wanna Make You Close Your Eyes	Dierks Bentley
No Problem	Chance The Rapper Featuring Lil Wayne & 2 Chainz
Beautiful Drug	Zac Brown Band
Blown Away	Carrie Underwood
Mask Off	Future
Blinding Lights	The Weeknd
American Girl	Bonnie McKee
Can’t Raise A Man	K. Michelle
If This Was a Movie	Taylor Swift
Heartache On The Dance Floor	Jon Pardi
Ho Hey	The Lumineers
Narcos	Migos
O Let’s Do It	Waka Flocka Flame
Take it Off	Ke$ha
2 Phones	Kevin Gates
​everytime	Ariana Grande
PUPPET	Tyler, The Creator
Not Afraid Anymore	Halsey
Buzzin’	Mann
Born to Be Yours	Kygo & Imagine Dragons
Hotline Bling	Drake
Redbone	Childish Gambino
Flatliner	Cole Swindell
Reality	Kenny Chesney
Enemies	Post Malone Featuring DaBaby
Meet Me Halfway	The Black Eyed Peas
Think Like a Man	Jennifer Hudson & Ne-Yo Featuring Rick Ross
Eight Second Ride	Jake Owen
BEST ON EARTH	Russ & BIA
Guys My Age	Hey Violet
Noise	Kenny Chesney
​pete davidson	Ariana Grande
Down	Fifth Harmony Featuring Gucci Mane
Make You Miss Me	Sam Hunt
R.I.C.O.	Meek Mill Featuring Drake
Boom Clap	Charli XCX
Way Down We Go	KALEO
DUCKWORTH.	Kendrick Lamar
Country Girl (Shake It for Me)	Luke Bryan
Dare (La La La)	Shakira
Paranoid (B.o.B Remix)	Ty Dolla $ign Featuring B.o.B
The Trouble with Girls	Scotty McCreery
Fine China	Chris Brown
6 Foot 7 Foot	Lil Wayne Featuring Cory Gunz
Do It Like Me	DLOW
Safe & Sound	Taylor Swift Featuring The Civil Wars
The Breath You Take	George Strait
Collard Greens	ScHoolboy Q Featuring Kendrick Lamar
Smoke	A Thousand Horses
Heavy	Linkin Park Featuring Kiiara
Most Girls	Hailee Steinfeld
Really Really	Kevin Gates
Freaky Friday	Lil Dicky Featuring Chris Brown
In Case You Didn’t Know	Brett Young
Something in the Water	Carrie Underwood
Beggin’ On Your Knees	Victorious Cast Featuring Victoria Justice
Need You Now	Lady Antebellum
Here For A Good Time	George Strait
Girl Crush	Little Big Town
Wanted You More	Lady Antebellum
Afire Love	Ed Sheeran
10 Bands	Drake
Scream	Usher
Post Malone - On the Road ft. Lil Baby & Meek Mill  (Traducción al Español)	Post Malone Featuring Meek Mill & Lil Baby
Break Free	Ariana Grande Featuring Zedd
Cornelia Street	Taylor Swift
Let It Go	James Bay
Police Dog Blues	Hugh Laurie
El Cerrito Place	Kenny Chesney
Cool Kids	Echosmith
Stupid Hoe	Nicki Minaj
Wasted Time	Keith Urban
Live A Little	Kenny Chesney
Hear Me Calling	Juice WRLD
Fall Down	will.i.am Featuring Miley Cyrus
​goodnight n go	Ariana Grande
Leave Me Alone	Flipp Dinero
Habits (Stay High)	Tove Lo
KEKE	6ix9ine, Fetty Wap & A Boogie Wit da Hoodie
Girls Chase Boys	Ingrid Michaelson
Location	Khalid
No Complaints	Metro Boomin Featuring Offset & Drake
Paris	The Chainsmokers
Homegrown Honey	Darius Rucker
Hollow	Tori Kelly
LUV	Tory Lanez
Sorry Not Sorry	Bryson Tiller
You Make Me Feel	Cobra Starship Featuring Sabi
A Guy Walks into a Bar	Tyler Farr
Love So Soft	Kelly Clarkson
Jump Out the Face	Meek Mill Featuring Future
Stunting Ain’t Nuthin	Gucci Mane Featuring Slim Jxmmi & Young Dolph
Craving You	Thomas Rhett Featuring Maren Morris
Smile (Living My Best Life)	Lil' Duval Featuring Snoop Dogg & Ball Greezy
Fly Over States	Jason Aldean
Tonight (Best You Ever Had)	John Legend Featuring Ludacris
Right Thru Me	Nicki Minaj
Kill This Love	BLACKPINK
Don’t Wake Me Up	Chris Brown
Beauty and a Beat	Justin Bieber Featuring Nicki Minaj
Famous	Kanye West
Geronimo	Sheppard
Just Can’t Get Enough	The Black Eyed Peas
Good As You	Kane Brown
Give It All We Got Tonight	George Strait
For Her	Chris Lane
Explosions	Ellie Goulding
Loving You No More	Diddy - Dirty Money Featuring Drake
Let It Go	Demi Lovato
Wasted	Juice WRLD Featuring Lil Uzi Vert
Never Stop	Future
Motiv8	J. Cole
She Don’t Love You	Eric Paslay
B.E.D.	Jacquees
Death of a Bachelor	Panic! At The Disco
Love’s Gonna Make It Alright	George Strait
Powerglide	Rae Sremmurd & Juicy J
Cruel Summer	Taylor Swift
Same Old Love	Selena Gomez
Blessings	Big Sean Featuring Drake
Soltera (Remix)	Lunay, Daddy Yankee & Bad Bunny
9	Drake
Break Your Heart (Remix)	Taio Cruz Featuring Ludacris
Focus	Ariana Grande
Ride	SoMo
The Sound of Silence	Disturbed
My Homies Still	Lil Wayne Featuring Big Sean
’Til Summer Comes Around	Keith Urban
You Make Me	Avicii
Drink In My Hand	Eric Church
Rolling in the Deep	Adele
Neutron Star Collision (Love Is Forever)	Muse
BO$$	Fifth Harmony
YOUTH	Troye Sivan
Take Me to Church	Hozier
Knockout	Lil Wayne Featuring Nicki Minaj
You Look Good	Lady Antebellum
Lover	Taylor Swift
American Kids	Kenny Chesney
Antisocial	Ed Sheeran & Travis Scott
Get Ugly	Jason Derulo
Dynamite	Taio Cruz
Can’t Take a Joke	Drake
God’s Country	Blake Shelton
Magnolia	Playboi Carti
Jumpsuit	twenty one pilots
Chun-Li	Nicki Minaj
Gangsta Luv	Snoop Dogg Featuring The-Dream
Watermelon Sugar	Harry Styles
Gucci Gucci	Kreayshawn
ELEMENT.	Kendrick Lamar
Good Life	G-Eazy & Kehlani
Five More Minutes	Scotty McCreery
The Greatest	Sia Featuring Kendrick Lamar
How Far I’ll Go	Alessia Cara
Empire	Shakira
You and Your Friends	Wiz Khalifa Featuring Snoop Dogg & Ty Dolla $ign
I Gotta Feeling	The Black Eyed Peas
Ours	Taylor Swift
2012 (It Ain’t the End)	Jay Sean Featuring Nicki Minaj
Hold On	Alabama Shakes
Fly	Maddie & Tae
The Lazy Song	Bruno Mars
Midnight City	M83.
Drowning	A Boogie Wit da Hoodie Featuring Kodak Black
I Do	Cardi B Featuring SZA
Animal	Neon Trees
Space Cadet	Metro Boomin Featuring Gunna
Cold One	Eric Church
2018 haywoodindahood Listening Log	Band Aid 30
Am I Wrong	Nico & Vinz
Sweet Dreams	Beyonce
Undo It	Carrie Underwood
Evacuate the Dancefloor	Cascada
Hate Me	Trippie Redd Featuring YoungBoy Never Broke Again
Up All Night	Drake Featuring Nicki Minaj
Daylight	Taylor Swift
This Is What It Feels Like	Armin van Buuren Featuring Trevor Guthrie
Drunk Me	Mitchell Tenpenny
Feel So Close	Calvin Harris
Heat	Chris Brown Featuring Gunna
Girl in a Country Song	Maddie & Tae
4:44	JAY-Z
She Looks So Perfect	5 Seconds Of Summer
Raise Your Glass	P!nk
Call It What You Want	Taylor Swift
Born to Be Somebody	Justin Bieber
Prisoner	The Weeknd Featuring Lana Del Rey
Shake Me Down	Cage The Elephant
Wish Wish	DJ Khaled Featuring Cardi B & 21 Savage
Live Like We’re Dying	Kris Allen
Little Miss	Sugarland
Apparently	J. Cole
#SELFIE	The Chainsmokers
Nobody Else But You	Trey Songz
Baggage Claim	Miranda Lambert
Don’t	Ed Sheeran
Battle Scars	Lupe Fiasco & Guy Sebastian
Heaven	Kane Brown
One More Drinkin’ Song	Jerrod Niemann
If I Lose Myself	OneRepublic
Don’t Let Me Down	The Chainsmokers Featuring Daya
Hold My Hand	Jess Glynne
Jumpin on a Jet	Future
Legend	Drake
Stuck On a Feeling	Prince Royce Featuring Snoop Dogg
Give Me Everything	Pitbull Featuring Ne-Yo, Afrojack & Nayer
Odio	Romeo Santos Featuring Drake
Today	Brad Paisley
Trampoline	SHAED
Peek a Boo	Lil Yachty Featuring Migos
RGF Island	Fetty Wap
See No More	Joe Jonas
Ain’t It Fun	Paramore
Look What You Made Me Do	Taylor Swift
Amnesia	5 Seconds Of Summer
Try	P!nk
Glass	Thompson Square
Drunk On Your Love	Brett Eldredge
DJ Khaled - I’m The One ft. Justin Bieber, Chance The Rapper, Quavo & Lil Wayne (Tradução em Português)	DJ Khaled Featuring Justin Bieber, Quavo, Chance The Rapper & Lil Wayne
Marry the Night	Lady Gaga
Diamond Teeth Samurai	YoungBoy Never Broke Again
Believe	Mumford & Sons
Drunk Girl	Chris Janson
Red Nose	Sage The Gemini
Can’t Sleep Love	Pentatonix
Right Above It	Lil Wayne Featuring Drake
Legends	Juice WRLD
Good Time	Owl City & Carly Rae Jepsen
Thinking About You	Calvin Harris Featuring Ayah Marar
Roses	benny blanco & Juice WRLD Featuring Brendon Urie
Filthy	Justin Timberlake
I’m Into You	Jennifer Lopez Featuring Lil Wayne
Fallin’ for You	Colbie Caillat
Til It’s Gone	Kenny Chesney
Lean On	Major Lazer & DJ Snake Featuring MO
JuJu On That Beat (TZ Anthem)	Zay Hilfigerrr & Zayion McCall
Touchin’ On My	3OH!3
London Boy	Taylor Swift
My Church	Maren Morris
Payphone	Maroon 5 Featuring Wiz Khalifa
Can’t Shake You	Gloriana
Hands To Myself	Selena Gomez
Done for Me	Charlie Puth Featuring Kehlani
Down in the DM (Remix)	Yo Gotti Featuring Nicki Minaj
Adore You	Harry Styles
Glitter in the Air	P!nk
We Are	Justin Bieber Featuring Nas
Two Is Better Than One	Boys Like Girls Featuring Taylor Swift
Doin’ What She Likes	Blake Shelton
All Around the World	Justin Bieber Featuring Ludacris
Tell Your Friends	The Weeknd
No Favors	Big Sean Featuring Eminem
When It Rains It Pours	Luke Combs
Work Hard, Play Hard	Wiz Khalifa
Cecilia and the Satellite	Andrew McMahon In The Wilderness
I Took a Pill in Ibiza	Mike Posner
SING	My Chemical Romance
A Little Party Never Killed Nobody (All We Got)	Fergie, Q-Tip & GoonRock
Try Everything	Shakira
BLOOD.	Kendrick Lamar
Came Here to Forget	Blake Shelton
Secrets	OneRepublic
TTYLXOX	Bella Thorne
Sex Ain’t Better Than Love	Trey Songz
Reply	A Boogie Wit da Hoodie Featuring Lil Uzi Vert
Wild Ones	Flo Rida Featuring Sia
Don’t Wanna Know	Maroon 5 Featuring Kendrick Lamar
Crazy Girl	Eli Young Band
4 AM	2 Chainz Featuring Travis Scott
A BOY IS A GUN*	Tyler, The Creator
Speak Now	Taylor Swift
Part of Me	Katy Perry
Me and My Broken Heart	Rixton
Starships	Nicki Minaj
CLOSE	Rae Sremmurd & Travis Scott
Today Was a Fairytale	Taylor Swift
Blank Space	Taylor Swift
In the Dark	Dev
Undrunk	FLETCHER
Side To Side	Ariana Grande Featuring Nicki Minaj
Tonight Looks Good on You	Jason Aldean
Tom Ford	JAY-Z
Cashin Out	Ca$h Out
Drink a Beer	Luke Bryan
Camila Cabello Talks Solo Music, Life After Fifth Harmony	Machine Gun Kelly x Camila Cabello
Juice	Yo Gotti
Shout Out to My Ex	Little Mix
Day Drinking	Little Big Town
Sparks Fly	Taylor Swift
Lose My Mind	Brett Eldredge
Goodbye Town	Lady Antebellum
Tomorrow	Chris Young
Kill Em With Kindness	Selena Gomez
Yikes	Kanye West
Homegrown	Zac Brown Band
A Year Without Rain	Selena Gomez & The Scene
Don’t Wanna Go Home	Jason Derulo
Southern Voice	Tim McGraw
Poker Face	Glee Cast
Havana	Camila Cabello Featuring Young Thug
Pirate Flag	Kenny Chesney
This Afternoon	Nickelback
Gonna Get This	Hannah Montana Featuring Iyaz
Sunny and 75	Joe Nichols
Lush Life	Zara Larsson
Boyfriend	Big Time Rush
Best Part	Daniel Caesar Featuring H.E.R.
Turn Up the Music	Chris Brown
Felices los 4	Maluma
High Hopes	Panic! At The Disco
Red	Taylor Swift
Baby by Me	50 Cent Featuring Ne-Yo
All Over Me	Josh Turner
Fairly Local	twenty one pilots
Come Get Her	Rae Sremmurd
It’s Nice to Have a Friend	Taylor Swift
Talk You Out of It	Florida Georgia Line
Drunk on a Plane	Dierks Bentley
Afterglow	Taylor Swift
I Won’t Let Go	Rascal Flatts
You And Tequila	Kenny Chesney Featuring Grace Potter
Female	Keith Urban
The End	Kings Of Leon
Without You	David Guetta Featuring Usher
​needy	Ariana Grande
You Look Like I Need a Drink	Justin Moore
All Kinds Of Kinds	Miranda Lambert
Faucet Failure	Ski Mask The Slump God
Talladega	Eric Church
Animals	Martin Garrix
House Party	Sam Hunt
Hey Daddy (Daddy’s Home) (Remix)	Usher Featuring Plies
Let Me Down Easy	Billy Currington
I Invented Sex	Trey Songz Featuring Drake
Sauce It Up	Lil Uzi Vert
We Dem Boyz	Wiz Khalifa
Gas Pedal	Sage The Gemini Featuring IamSu!
Perplexing Pegasus	Rae Sremmurd
Run the World (Girls)	Beyonce
Malibu	Miley Cyrus
Singing in the Rain / Umbrella	Glee Cast Featuring Gwyneth Paltrow
Waiting for the End	Linkin Park
Heart Attack	Demi Lovato
The A Team	Ed Sheeran
Desperate Man	Eric Church
Candy	Doja Cat
Don’t Let Me Be Lonely	The Band Perry
The Outsiders	Eric Church
Zombie	Bad Wolves
A Lie	French Montana Featuring The Weeknd & Max B
My Way	Calvin Harris
Top Off	DJ Khaled Featuring JAY Z, Future & B
Gangsta	Kehlani
What Kind of Man	Florence + The Machine
Finding My Way Back	Jaheim
Antidote	Travis Scott
Transportin’	Kodak Black
CAN’T STOP THE FEELING!	Justin Timberlake
Call the Coroner	Future
All I Ask	Adele
My Way	Fetty Wap Featuring Monty
Pt. 2	Kanye West
I Can’t Get Enough	benny blanco, Tainy, Selena Gomez & J Balvin
Just Gettin’ Started	Jason Aldean
How Low	Ludacris
Here	Alessia Cara
Hall of Fame	The Script Featuring will.i.am
​human	Christina Perri
Wanna Be That Song	Brett Eldredge
Take One	Kodak Black
I Get the Bag	Gucci Mane Featuring Migos
Next to Me	Emeli Sande
​R.E.M.	Ariana Grande
Mo Bamba	Sheck Wes
Hard	Rihanna Featuring Jeezy
Naturally	Selena Gomez & The Scene
Still into You	Paramore
Try Sleeping with a Broken Heart	Alicia Keys
Dog Days Are Over	Florence + The Machine
Love on Top	Beyonce
Diamonds	Rihanna
Plug Walk	Rich The Kid
Thunder	Imagine Dragons
Lonely Tonight	Blake Shelton Featuring Ashley Monroe
Best Friend	Sofi Tukker Featuring NERVO, The Knocks & Alisa Ueno
Monster	Kanye West Featuring Jay-Z, Rick Ross, Bon Iver & Nicki Minaj
We Are Young	Glee Cast
Mine Would Be You	Blake Shelton
LIKE I WOULD	Zayn
T-Shirt	Thomas Rhett
Just Fishin’	Trace Adkins
Gorgeous	Taylor Swift
Good Girl	Carrie Underwood
I Bet	Ciara
WAKE UP	Travis Scott
Miss Americana & The Heartbreak Prince	Taylor Swift
My Kinda Party	Jason Aldean
Circles	Post Malone
I Love This Life	LOCASH
Body	Loud Luxury Featuring Brando
Got 2 Luv U	Sean Paul Featuring Alexis Jordan
No Hurry	Zac Brown Band
Watch Out	2 Chainz
All of the Lights	Kanye West
Hey Look Ma, I Made It	Panic! At The Disco
Marry You	Bruno Mars
Can’t Feel My Face	The Weeknd
Sucker	Jonas Brothers
Magic	Coldplay
In the Name of Love	Martin Garrix & Bebe Rexha
FEAR.	Kendrick Lamar
Key To The Streets	YFN Lucci Featuring Migos & Trouble
Better Man	Little Big Town
No Pressure	Justin Bieber Featuring Big Sean
Make It Sweet	Old Dominion
I Gotta Get To You	George Strait
Sweet Nothing	Calvin Harris Featuring Florence Welch
Come Get It Bae	Pharrell Williams
God Made Girls	RaeLynn
Heart Attack	Trey Songz
Adorn	Miguel
In the Night	The Weeknd
Rudolph The Red-Nosed Reindeer	Gene Autry
Rudolph The Red-Nosed Reindeer	Gene Autry
Relationship	Young Thug Featuring Future
Hardaway	Derez De'Shon
The Truth	Jason Aldean
Sweet But Psycho	Ava Max
QUÉ PRETENDES	J Balvin & Bad Bunny
Wasting All These Tears	Cassadee Pope
Bullets In The Gun	Toby Keith
Raise Your Glass	Glee Cast
Elevator	Eminem
​make up	Ariana Grande
Panda	Desiigner
Goodnight Kiss	Randy Houser
Jumpman	Drake & Future
Diced Pineapples	Rick Ross Featuring Wale & Drake
Don’t Mind	Kent Jones
Lucid Dreams	Juice WRLD
Neon Light	Blake Shelton
So Good	B.o.B
More Than Miles	Brantley Gilbert
The Man I Want to Be	Chris Young
The Man I Want to Be	Chris Young
Southern Girl	Tim McGraw
Homeboy	Eric Church
Studio	ScHoolboy Q Featuring BJ The Chicago Kid
Freaks	French Montana Featuring Nicki Minaj
This Ole Boy	Craig Morgan
Danza Kuduro	Don Omar & Lucenzo
Written In the Sand	Old Dominion
Country Song	Seether
Pretty Girl Rock	Keri Hilson
Body 2 Body	Ace Hood Featuring Chris Brown
You & I	One Direction
Love King	The-Dream
Diamonds Dancing	Drake & Future
You Was Right	Lil Uzi Vert
Main Chick	Kid Ink Featuring Chris Brown
Heartbeat	The Fray
Mayores	Becky G Featuring Bad Bunny
Pants on the Ground	General Larry Platt
Invisible	Hunter Hayes
Memories	Maroon 5
Right by My Side	Nicki Minaj Featuring Chris Brown
Bacc at it Again	Yella Beezy, Gucci Mane & Quavo
Shoota	Playboi Carti Featuring Lil Uzi Vert
Time of Our Lives	Pitbull & Ne-Yo
Pills N Potions	Nicki Minaj
Animals	Maroon 5
Best I Ever Had	Gavin DeGraw
Rotten to the Core	Dove Cameron, Cameron Boyce, Booboo Stewart & Sofia Carson
Team	Iggy Azalea
Comfortable	K Camp
Steal My Girl	One Direction
Life Goes On	Lil Baby Featuring Gunna & Lil Uzi Vert
Ginza	J Balvin
Die For Me	Post Malone Featuring Future & Halsey
Trailerhood	Toby Keith
Slow Hands	Niall Horan
Try Me	DeJ Loaf
BUTTERFLY EFFECT	Travis Scott
Felt Good On My Lips	Tim McGraw
Trap Queen	Fetty Wap
Oh My	DJ Drama Featuring Fabolous, Roscoe Dash & Wiz Khalifa
Death by a Thousand Cuts	Taylor Swift
I’m Ready	AJR
Carry Out	Timbaland Featuring Justin Timberlake
Beautiful Trauma	P!nk
Royals	Lorde
No Worries	Lil Wayne Featuring Detail
Happier	Marshmello & Bastille
California King Bed	Rihanna
Somewhere Else	Toby Keith
No Tellin’	Drake
Drowns the Whiskey	Jason Aldean Featuring Miranda Lambert
I Get It In	Omarion Featuring Gucci Mane
Grove St. Party	Waka Flocka Flame Featuring Kebo Gotti
Futsal Shuffle 2020	Lil Uzi Vert
New Freezer	Rich The Kid Featuring Kendrick Lamar
Make It Back	Juice WRLD
New Rules	Dua Lipa
Like a Cowboy	Randy Houser
Beat This Summer	Brad Paisley
We Are Tonight	Billy Currington
Wish I Knew You	The Revivalists
Burnin’ Up (feat. 2 Chainz) (Gazzo Remix Radio Edit)	Jessie J Featuring 2 Chainz
Crash and Burn	Thomas Rhett
Keep Me in Mind	Zac Brown Band
Glory	Common & John Legend
Say Aah	Trey Songz Featuring Fabolous
Bank Account	21 Savage
Last Christmas	Wham!
​monster	21 Savage
Who Do You Love	The Chainsmokers Featuring 5 Seconds Of Summer
​bad guy	Billie Eilish
Natural	Imagine Dragons
Bad Liar	Selena Gomez
Tip It on Back	Dierks Bentley
In My Feelings	Drake
Money	Cardi B
With You Tonight (Hasta El Amanecer)	Nicky Jam
Shot Clock	Ella Mai
Go Get It	T.I.
Don’t Come Out the House	Metro Boomin Featuring 21 Savage
Part II (On the Run)	Jay Z Featuring Beyonce
Suge	DaBaby
PYD	Justin Bieber Featuring R. Kelly
Angel in Blue Jeans	Train
Temptation	Future
Pontoon	Little Big Town
I Know What You Did Last Summer	Shawn Mendes & Camila Cabello
Say It	Tory Lanez
Fast	Luke Bryan
POWER	Kanye West
1999	Prince
Échame La Culpa	Luis Fonsi & Demi Lovato
​bloodline	Ariana Grande
When We	Tank
Tonight Tonight	Hot Chelle Rae
I Will Never Let You Down	Rita Ora
5 O’Clock	T-Pain Featuring Wiz Khalifa & Lily Allen
Teenage Dream	Glee Cast
Look Alive	Rae Sremmurd
Gorilla	Bruno Mars
Little Talks	Of Monsters And Men
Get It Right	Glee Cast
Sin Pijama	Becky G + Natti Natasha
Scream & Shout	will.i.am & Britney Spears
Purpose	Justin Bieber
I Don’t Like	Chief Keef Featuring Lil Reese
September	Daughtry
Hold You Down	DJ Khaled Featuring Chris Brown, August Alsina, Future & Jeremih
DHL	Frank Ocean
Simple	Florida Georgia Line
Bottoms Up	Trey Songz Featuring Nicki Minaj
Sparks	Hilary Duff
Going Bad	Meek Mill Featuring Drake
Everybody Talks	Neon Trees
Youngblood	5 Seconds Of Summer
A Thousand Bad Times	Post Malone
What Lovers Do	Maroon 5 Featuring SZA
Lonely Eyes	Chris Young
Va Va Voom	Nicki Minaj
I Got You	Bebe Rexha
CoCo	O.T. Genasis
R.I.P.	Young Jeezy Featuring 2 Chainz
Love Someone	Lukas Graham
The Ringer	Eminem
MIDDLE CHILD	J. Cole
Drag Me Down	One Direction
Tapout	Rich Gang Featuring Lil Wayne, Birdman, Future, Mack Maine, Nicki Minaj
All Your Life	The Band Perry
The Git Up	Blanco Brown
Look What God Gave Her	Thomas Rhett
Creepin	Eric Church
Same Damn Time	Future
China	Anuel AA, Daddy Yankee, Karol G, Ozuna & J Balvin
Who Needs Love	Trippie Redd
Come With Me Now	KONGOS
No Sleep	Wiz Khalifa
That Don’t Sound Like You	Lee Brice
Boyfriend	Justin Bieber
No Flex Zone	Rae Sremmurd
Settle Down	No Doubt
Love Me Like You Do	Ellie Goulding
Take It to the Head	DJ Khaled Featuring Chris Brown, Rick Ross, Nicki Minaj & Lil Wayne
Good Feeling	Flo Rida
Southern Comfort Zone	Brad Paisley
Black	Dierks Bentley
FEEL.	Kendrick Lamar
Helium	Sia
Hell to the No	Glee Cast
Billionaire	Travie McCoy Featuring Bruno Mars
Fast Car	Jonas Blue Featuring Dakota
Love More	Chris Brown Featuring Nicki Minaj
Into You	Ariana Grande
All On Me	Devin Dawson
Mind Reader	Dustin Lynch
Calling My Spirit	Kodak Black
Tighten Up	The Black Keys
Marry Me	Train
Mama’s Broken Heart	Miranda Lambert
As She’s Walking Away	Zac Brown Band Featuring Alan Jackson
Mmm Yeah	Austin Mahone Featuring Pitbull
Easy	Sheryl Crow
Fight Night	Migos
Blasé	Ty Dolla $ign Featuring Future & Rae Sremmurd
Everything’s Gonna Be Alright	David Lee Murphy & Kenny Chesney
Young and Beautiful	Lana Del Rey
50 Ways to Say Goodbye	Train
Be Real	Kid Ink Featuring DeJ Loaf
Flex (Ooh, Ooh, Ooh)	Rich Homie Quan
Video Phone (Extended Remix)	Beyonce Featuring Lady Gaga
Welcome to My Hood	DJ Khaled Featuring Rick Ross, Plies, Lil Wayne & T-Pain
Let Me Go	Avril Lavigne Featuring Chad Kroeger
Take A Little Ride	Jason Aldean
Highway 20 Ride	Zac Brown Band
Call You Mine	The Chainsmokers & Bebe Rexha
To the Max	DJ Khaled Featuring Drake
Blue Tacoma	Russell Dickerson
Jet Lag	Future & Juice WRLD Featuring Young Scooter
Slow Down	Selena Gomez
Just A Kiss	Lady Antebellum
Why Don’t We Just Dance	Josh Turner
She’s with Me	High Valley
Poetic Justice	Kendrick Lamar Featuring Drake
I Like Me Better	Lauv
Setting Fires	The Chainsmokers Featuring XYLO
Wildflower	The JaneDear Girls
Your Body	Christina Aguilera
Beautiful Monster	Ne-Yo
Drip	Cardi B Featuring Migos
Drinkin’ Problem	Midland
Play Hard	David Guetta Featuring Ne-Yo & Akon
​asmr	21 Savage
Go Hard or Go Home	Wiz Khalifa & Iggy Azalea
Sweater Weather	The Neighbourhood
Follow God	Kanye West
Barbie Tingz	Nicki Minaj
​​no tears left to cry	Ariana Grande
Clarity	Zedd Featuring Hayley Williams
Clarity	Zedd Featuring Foxes
Yeah 3x	Chris Brown
Love You Like That	Canaan Smith
Dirt Road Anthem	Jason Aldean
In My Blood	Shawn Mendes
Can’t Be Tamed	Miley Cyrus
Always Remember Us This Way	Lady Gaga
Whataya Want From Me	Adam Lambert
Time Is Love	Josh Turner
All We Know	The Chainsmokers Featuring Phoebe Ryan
I Never Told You	Colbie Caillat
Cash Shit	Megan Thee Stallion Featuring DaBaby
Meanwhile Back at Mama’s	Tim McGraw Featuring Faith Hill
Bad Liar	Imagine Dragons
Happier	Ed Sheeran
All About It	Hoodie Allen Featuring Ed Sheeran
Beautiful Crazy	Luke Combs
Wild for the Night	A$AP Rocky Featuring Skrillex
Earth	Lil Dicky
Chandelier	Sia
I Don’t Like It, I Love It	Flo Rida Featuring Robin Thicke & Verdine White
Say You Do	Dierks Bentley
Tattoos On This Town	Jason Aldean
Bon, Bon	Pitbull
Alive	Krewella
Venom	Eminem
Wiggle	Jason Derulo Featuring Snoop Dogg
Mark My Words	Justin Bieber
Delirious (Boneless)	Steve Aoki, Chris Lake & Tujamo Featuring Kid Ink
About You	Trey Songz
The Man	Aloe Blacc
Are You Gonna Kiss Me or Not	Thompson Square
Grenade	Bruno Mars
One That Got Away	Michael Ray
She’s So Mean	matchbox twenty
Paramedic!	SOB X RBE
Talking Body	Tove Lo
Give a Little More	Maroon 5
I Wanna Dance with Somebody (Who Loves Me)	Whitney Houston
Easier	5 Seconds Of Summer
Nowadays	Lil Skies Featuring Landon Cube
Every Teardrop Is a Waterfall	Coldplay
Hello, Good Morning	Diddy - Dirty Money Featuring T.I.
Compass	Lady Antebellum
ATM	J. Cole
Graveyard	Halsey
Hair	Lady Gaga
Made for Now	Janet & Daddy Yankee
Live from the Gutter	Drake & Future
Stir Fry	Migos
Smoke a Little Smoke	Eric Church
Cooler Than Me	Mike Posner
I’ve Been Waiting	Lil Peep & iLoveMakonnen Featuring Fall Out Boy
​ghostin	Ariana Grande
Rich & Sad	Post Malone
Privacy	Chris Brown
Mercy	Brett Young
Ridin’ Roads	Dustin Lynch
Blessings (Reprise)	Chance The Rapper Featuring Ty Dolla $ign
Astronauts	Future & Juice WRLD
Wrecking Ball	Miley Cyrus
Shallow	Lady Gaga & Bradley Cooper
Lost in the Fire	Gesaffelstein & The Weeknd
Dangerous	David Guetta Featuring Sam Martin
Yellow Hearts	Ant Saunders
Mr. Wrong	Mary J. Blige Featuring Drake
Work Out	J. Cole
Yeah Boy	Kelsea Ballerini
The Worst	Jhene Aiko
Pure Imagination	Glee Cast
Make Me Like You	Gwen Stefani
5-1-5-0	Dierks Bentley
Buy Me a Boat	Chris Janson
1.5	21 Savage
Peter Pan	Kelsea Ballerini
10,000 Hours	Dan + Shay & Justin Bieber
Break on Me	Keith Urban
Turn Around (5, 4, 3, 2, 1)	Flo Rida
Every Little Thing	Carly Pearce
Out the Mud	Lil Baby Featuring Future
Taylor Swift - End Game ft. Ed Sheeran & Future (Deutsche Übersetzung)	Taylor Swift Featuring Ed Sheeran & Future
Dark Side	Kelly Clarkson
Right There	Nicole Scherzinger Featuring 50 Cent
Monster	Imagine Dragons
Selfish	PnB Rock
Temporary Fix	One Direction
Alone With You	Jake Owen
One Hell Of An Amen	Brantley Gilbert
SICKO MODE	Travis Scott
Birthday	Katy Perry
Capsize	Frenship & Emily Warren
It Won’t Stop (Remix)	Sevyn Streeter Featuring Chris Brown
Dance Monkey	Tones And I
365	Zedd & Katy Perry
Playing Games	Summer Walker
Frick Park Market	Mac Miller
We Can’t Stop	Miley Cyrus
Ocean	TK Kravitz Featuring Jacqueez
THat Part	ScHoolboy Q Featuring Kanye West
Be Careful	Cardi B
...Ready for It?	Taylor Swift
Like I’m Gonna Lose You	Meghan Trainor Featuring John Legend
Small Town Boy	Dustin Lynch
Greatest Love Story	LANCO
Curve	Gucci Mane Featuring The Weeknd
I Think He Knows	Taylor Swift
Anywhere With You	Jake Owen
Ville Mentality	J. Cole
What the Hell	Avril Lavigne
Ride	twenty one pilots
Mr. Saxobeat	Alexandra Stan
Hello World	Lady Antebellum
How I’ll Always Be	Tim McGraw
Cool for the Summer	Demi Lovato
I Can’t Go for That / You Make My Dreams	Glee Cast
Burning House	Cam
Take Me Home	Cash Cash Featuring Bebe Rexha
Pretty Boy Swag	Soulja Boy Tell'em
Hope	XXXTENTACION
Wild Things	Alessia Cara
Unforgettable	Thomas Rhett
Homesick	Kane Brown
Me and Your Mama	Childish Gambino
All I Ever Wanted	Kelly Clarkson
Smooth	Florida Georgia Line
Candy Paint	Post Malone
Bailando	Enrique Iglesias Featuring Descemer Bueno & Gente de Zona
Uptown Funk	Mark Ronson Featuring Bruno Mars
Amen	Meek Mill Featuring Drake
Hotel Key	Old Dominion
Best Friend	Young Thug
Lettin’ the Night Roll	Justin Moore
New Music Friday 08/10/18	Quavo
Nightmare	Halsey
Fake Love	Drake
This Is It	Scotty McCreery
Thinking Out Loud	Ed Sheeran
Neon Lights	Demi Lovato
The Cure	Lady Gaga
The Monster	Eminem Featuring Rihanna
The Monster	Rihanna Featuring Drake
Work	Eminem Featuring Rihanna
Work	Rihanna Featuring Drake
B.M.F. (Blowin’ Money Fast)	Rick Ross Featuring Styles P
If We Ever Meet Again	Timbaland Featuring Katy Perry
Love Myself	Hailee Steinfeld
La La La	Naughty Boy Featuring Sam Smith
E.T. (Remix)	Katy Perry Featuring Kanye West
The Wind	Zac Brown Band
Cut It	O.T. Genasis Featuring Young Dolph
Reminder	The Weeknd
Fight Song	Rachel Platten
We Don’t Talk Anymore	Charlie Puth Featuring Selena Gomez
Powerful	Major Lazer Featuring Ellie Goulding & Tarrus Riley
Holy Grail	Jay Z Featuring Justin Timberlake
Superheroes	The Script
Outta My Head	Craig Campbell
Middle of a Memory	Cole Swindell
Here Tonight	Brett Young
Break the Rules	Charli XCX
Breakeven	The Script
Too Much to Ask	Niall Horan
​imagine	Ariana Grande
My Moment	DJ Drama Featuring 2 Chainz, Meek Mill & Jeremih
Overdose	YoungBoy Never Broke Again
Congratulations	Post Malone Featuring Quavo
Act Up	City Girls
6 God	Drake
Glad You Came	The Wanted
Lean And Dabb	iLoveMemphis
Toot It And Boot It	YG
Girls Talk Boys	5 Seconds Of Summer
FAKE LOVE	BTS
Countdown	Beyonce
Unforgettable	French Montana Featuring Swae Lee
Leave Your Lover	Sam Smith
Whistle	Flo Rida
Close Your Eyes	Parmalee
What Makes You Country	Luke Bryan
Ass Back Home	Gym Class Heroes Featuring Neon Hitch
Your Love	Nicki Minaj
22	Taylor Swift
She Twerkin	Ca$h Out
To the World	Kanye West, R. Kelly
Tear in My Heart	twenty one pilots
Woohoo	Christina Aguilera Featuring Nicki Minaj
Beat It	Sean Kingston Featuring Chris Brown & Wiz Khalifa
She Don’t Put It Down	Joe Budden Featuring Lil Wayne & Tank
They Don’t Know	Jason Aldean
1994	Jason Aldean
Nice For What	Drake
Fade	Kanye West
Feel No Ways	Drake
Set Fire to the Rain	Adele
Strong	One Direction
Nice to Meet Ya	Niall Horan
Red Opps	21 Savage
Stressed Out	twenty one pilots
Truck Yeah	Tim McGraw
Sweet Love	Chris Brown
Steady Mobbin’	Young Money Featuring Gucci Mane
Dear Future Husband	Meghan Trainor
Good Kisser	Usher
Some of It	Eric Church
Ophelia	The Lumineers
You and Your Heart	Jack Johnson
Fireflies	Owl City
Take It from Me	Jordan Davis
I Feel It Coming	The Weeknd Featuring Daft Punk
She Ain’t You	Chris Brown
Runaway	Kanye West Featuring Pusha T
I Was Jack (You Were Diane)	Jake Owen
Shower	Becky G
Back to December	Taylor Swift
Hooked	Dylan Scott
I Can Only Imagine	David Guetta Featuring Chris Brown & Lil Wayne
Drop the World	Lil Wayne Featuring Eminem
I Keep On Lovin’ You	Reba
44 More	Logic
​thank u, next	Ariana Grande
Scared to Be Lonely	Martin Garrix & Dua Lipa
SAD!	XXXTENTACION
HIGHEST IN THE ROOM	Travis Scott
Hot Now	YoungBoy Never Broke Again
Stubborn Love	The Lumineers
Back to Black	Glee Cast
Cheyenne	Jason Derulo
Be Alright	Dean Lewis
Back in Time	Pitbull
A Little More Summertime	Jason Aldean
Again	Fetty Wap
How I Feel	Flo Rida
Another Way to Die	Disturbed
Waka Waka (This Time for Africa)	Shakira Featuring Freshlyground
New Flame	Chris Brown Featuring Usher & Rick Ross
Rollin	Calvin Harris Featuring Future & Khalid
Over You	Miranda Lambert
She Will	Lil Wayne Featuring Drake
Love and War	Tamar Braxton
1901	Phoenix
Paranoid	Post Malone
Tennessee Whiskey	Chris Stapleton
Better Than I Know Myself	Adam Lambert
Solo	Iyaz
All Me	Drake Featuring 2 Chainz & Big Sean
Young, Dumb & Broke, Bank Account, & Bodak Yellow Mashup	Cardi B
Young Girls	Bruno Mars
Team	Lorde
What Happens in a Small Town	Brantley Gilbert + Lindsay Ell
Pompeii	Bastille
All The Stars	Kendrick Lamar & SZA
You Belong with Me	Taylor Swift
Speechless	Dan + Shay
Stay	Florida Georgia Line
Everybody Dies in Their Nightmares	XXXTENTACION
When She Says Baby	Jason Aldean
Lolly	Maejor Ali Featuring Juicy J & Justin Bieber
Look at Me Now	Chris Brown Featuring Lil Wayne & Busta Rhymes
Gucci Flip Flops	Bhad Bhabie Featuring Lil Yachty
Tornado	Little Big Town
I Don’t Care	Ed Sheeran & Justin Bieber
Truth Hurts	Lizzo
Do I Make You Wanna	Billy Currington
Loser Like Me	Glee Cast
Yoga	Janelle Monae & Jidenna
BedRock	Young Money Featuring Lloyd
Brand New	Ben Rector
Love Is An Open Door	Kristen Bell & Santino Fontana
The Language	Drake
Alright	Kendrick Lamar
My Girl	Dylan Scott
Pure Water	Mustard & Migos
Adicto	Tainy, Anuel AA & Ozuna
All Eyez	The Game Featuring Jeremih
She’s Got a Way With Words	Blake Shelton
Love All Over Me	Monica
Pop That	French Montana Featuring Rick Ross, Drake, Lil Wayne
Riptide	Vance Joy
Piece by Piece	Kelly Clarkson
Omertà	Drake
Truffle Butter	Nicki Minaj Featuring Drake & Lil Wayne
Nasty	Bandit Gang Marco Featuring Dro
Splashin	Rich The Kid
Stand By You	Rachel Platten
Me Too	Meghan Trainor
Demons and Angels	A Boogie Wit da Hoodie Featuring Juice WRLD
Bed	Nicki Minaj Featuring Ariana Grande
Dangerous	Meek Mill Featuring Jeremih & PnB Rock
Best Thing I Never Had	Beyonce
Shotgun Rider	Tim McGraw
Remember You Young	Thomas Rhett
Close	Nick Jonas Featuring Tove Lo
We R Who We R	Ke$ha
Who Do You Love?	YG Featuring Drake
Get Dripped	Lil Yachty Featuring Playboi Carti
Drink To That All Night	Jerrod Niemann
Drank In My Cup	Kirko Bangz
Alone	Marshmello
Til My Last Day	Justin Moore
X	Chris Brown
Trouble	Iggy Azalea Featuring Jennifer Hudson
Backwoods	Justin Moore
Can’t Get Enough	J. Cole Featuring Trey Songz
First Day Out	Tee Grizzley
Friday	Glee Cast
For Whom the Bell Tolls	J. Cole
Nothing Breaks Like a Heart	Mark Ronson Featuring Miley Cyrus
Give Me Back My Hometown	Eric Church
Lamborghini Angels	Lupe Fiasco
Somebody Else Will	Justin Moore
Bounce It	Juicy J Featuring Wale & Trey Songz
Not a Bad Thing	Justin Timberlake
Woman, Amen	Dierks Bentley
Ocean	Martin Garrix Featuring Khalid
PICK IT UP	Famous Dex Featuring A$AP Rocky
Good Girl	Dustin Lynch
Perfect	One Direction
The Bones	Maren Morris
Child’s Play	Drake
Double Vision	3OH!3
Pray	Justin Bieber
Controlla	Drake
Jack Sparrow	The Lonely Island Featuring Michael Bolton
What We Ain’t Got	Jake Owen
Lean Wit Me	Juice WRLD
Marry Me	Jason Derulo
Thotiana	Blueface
Fancy	Iggy Azalea Featuring Charli XCX
On My Way to You	Cody Johnson
Look Back at It	A Boogie Wit da Hoodie
The One That Got Away	Katy Perry
Old Alabama	Brad Paisley Featuring Alabama
No Church in the Wild	Jay Z Kanye West Featuring Frank Ocean
M.I.L.F. $	Fergie
Swish Swish	Katy Perry Featuring Nicki Minaj
A Woman Like You	Lee Brice
Get Low	Dillon Francis & DJ Snake
Ain’t Worth the Whiskey	Cole Swindell
The Archer	Taylor Swift
Sixteen	Thomas Rhett
Change	J. Cole
Somewhere With You	Kenny Chesney
What They Want	Russ
Kissin U	Miranda Cosgrove
Emperor’s New Clothes	Panic! At The Disco
Don’t	Bryson Tiller
Long Hot Summer	Keith Urban
Blow	Ke$ha
Safety Dance	Glee Cast
Keanu Reeves	Logic
Raging Fire	Phillip Phillips
​do re mi	blackbear
Porn Star Dancing	My Darkest Days Featuring Zakk Wylde
Don’t Ya	Brett Eldredge
Treat You Better	Shawn Mendes
Blue Christmas	Elvis Presley
I’m Upset	Drake
Ballin’	Mustard & Roddy Ricch
Who Gon Stop Me	Jay Z Kanye West
The Man	Taylor Swift
The Story of Us	Taylor Swift
Clique	Kanye West, Jay-Z, Big Sean
The Cut Off	J. Cole Featuring kiLL edward
Ready Set Roll	Chase Rice
Hymn for the Weekend	Coldplay
Blackout	Breathe Carolina
Somebody to Love (Remix)	Justin Bieber Featuring Usher
Russian Roulette	Rihanna
Play No Games	Big Sean Featuring Chris Brown & Ty Dolla $ign
Somebody to Love	Jordan Smith
Beer Never Broke My Heart	Luke Combs
Outside Today	YoungBoy Never Broke Again
Happy Holiday/The Holiday Season	Andy Williams
Crawl	Chris Brown
Hello	Martin Solveig & Dragonette
Bound 2	Kanye West
Give Your Heart a Break	Demi Lovato
Survival	Eminem
Psycho	Post Malone Featuring Ty Dolla $ign
Go Loko	YG, Tyga & Jon Z
Like I Loved You	Brett Young
​my strange addiction	Billie Eilish
Who Says	Selena Gomez & The Scene
Immortals	Fall Out Boy
Call Me Maybe	Carly Rae Jepsen
Barefoot Blue Jean Night	Jake Owen
Come Thru	Summer Walker & Usher
All Mine	Kanye West
All of Me	John Legend
Fistful of Tears	Maxwell
El Amante	Nicky Jam
Beat of the Music	Brett Eldredge
How Many Times	DJ Khaled Featuring Chris Brown, Lil Wayne & Big Sean
Unstoppable	Rascal Flatts
Why Wait	Rascal Flatts
Donald Trump	Mac Miller
Shameless	Camila Cabello
Knock Knock	Mac Miller
Secrets	Mary Lambert
King of Anything	Sara Bareilles
You	Chris Young
Too Good at Goodbyes	Sam Smith
I Wanna Rock	Snoop Dogg
Finesse (Remix)	Bruno Mars & Cardi B
Freak the Freak Out	Victorious Cast Featuring Victoria Justice
Roses	The Chainsmokers Featuring Rozes
Everything I Shouldn’t Be Thinking About	Thompson Square
Stereo Hearts	Glee Cast
Locked Out of Heaven	Bruno Mars
Buy My Own Drinks	Runaway June
Better With the Lights Off	New Boyz Feat. Chris Brown
Ice Tray	Quavo & Lil Yachty
​fake smile	Ariana Grande
The Race	Tay-K
Bright	Echosmith
Not Myself Tonight	Christina Aguilera
Uproar	Lil Wayne
I Love You This Big	Scotty McCreery
We the People....	A Tribe Called Quest
Let Me Know (I Wonder Why Freestyle)	Juice WRLD
Leave the Night On	Sam Hunt
Like Jesus Does	Eric Church
Wagon Wheel	Darius Rucker
​you should see me in a crown	Billie Eilish
Postcard from Paris	The Band Perry
Let Me See Ya Girl	Cole Swindell
GIRL	Maren Morris
Big Ole Freak	Megan Thee Stallion
Dark Knight Dummo	Trippie Redd Featuring Travis Scott
Rearview Town	Jason Aldean
Raise ’Em Up	Keith Urban Featuring Eric Church
Right There	Ariana Grande Featuring Big Sean
Crushin’ It	Brad Paisley
My Oh My	Camila Cabello Featuring DaBaby
Summer Nights	Glee Cast
I Don’t Know About You	Chris Lane
You Da One	Rihanna
Work	Iggy Azalea
Underneath the Tree	Kelly Clarkson
Better Dig Two	The Band Perry
Into the Unknown	Idina Menzel & AURORA
I See You	Luke Bryan
Dance (A$$) (Remix)	Big Sean Featuring Nicki Minaj
Something in the Way You Move	Ellie Goulding
​everything i wanted	Billie Eilish
Red Roses	Lil Skies Featuring Landon Cube
Who Booty	Jonn Hart Featuring IamSU!
Irresistible	Fall Out Boy
Triggered (freestyle)	Jhene Aiko
Africa	Weezer
Smoke In Peace ( Roll In Peace) Reject Remix ( Kodak Black , XXXtentacion)	Kodak Black Featuring XXXTENTACION
Tip of My Tongue	Kenny Chesney
XO	Beyonce
1Night	Lil Yachty
Slide	French Montana Featuring Blueface & Lil Tjay
The Hanging Tree	James Newton Howard Featuring Jennifer Lawrence
Worth It	Fifth Harmony Featuring Kid Ink
Empty	Juice WRLD
Cost of Livin’	Ronnie Dunn
Into the Unknown (Panic! at the Disco Version)	Panic! At The Disco
Tequila	Dan + Shay
Blood on the Leaves	Kanye West
I Do	Colbie Caillat
Downtown’s Dead	Sam Hunt
Love Someone	Brett Eldredge
Dive In	Trey Songz
Yeah	Joe Nichols
Exchange	Bryson Tiller
I Forgot That You Existed	Taylor Swift
Somebody to Love	Glee Cast
​when the party’s over	Billie Eilish
Gucci Gang	Lil Pump
Slide Away	Miley Cyrus
Ghost Town	Adam Lambert
ESSKEETIT	Lil Pump
Chocolate	The 1975
Man Down	Rihanna
Country Must Be Country Wide	Brantley Gilbert
Last Friday Night (T.G.I.F.)	Katy Perry
Impossible	Shontelle
Love Lies	Khalid & Normani
Eenie Meenie	Sean Kingston & Justin Bieber
Rocketeer	Far*East Movement Featuring Ryan Tedder
Wild Thoughts	DJ Khaled Featuring Rihanna & Bryson Tiller
Rolling in the Deep	Glee Cast Featuring Jonathan Groff
You Lie	The Band Perry
Ai Se Eu Te Pego	Michel Telo
Wat U Mean (Aye, Aye, Aye)	Dae Dae
Miss Jackson	Panic! At The Disco Featuring Lolo
Cheers (Drink to That)	Rihanna
100	The Game Featuring Drake
Christmas (Baby Please Come Home)	Darlene Love
Smoke Break	Carrie Underwood
Anything Goes	Florida Georgia Line
Bottoms Up	Brantley Gilbert
Banjo	Rascal Flatts
Sorry for Party Rocking	LMFAO
Worst Behavior	Drake
Love Never Felt So Good	Michael Jackson & Justin Timberlake
One Way Or Another (Teenage Kicks)	One Direction
Bed of Lies	Nicki Minaj Featuring Skylar Grey
May We All	Florida Georgia Line Featuring Tim McGraw
Good Vibes	Chris Janson
Burning Man	Dierks Bentley Featuring Brothers Osborne
I’ll Never Love Again (Extended Version)	Lady Gaga
Cryin’ Like a Bitch	Godsmack
Got Your Back	T.I. Featuring Keri Hilson
Rodeo	Lil Nas X & Cardi B Or Nas
Get Used to It	Justin Bieber
Fuck Up Some Commas	Future
PRBLMS	6LACK
Little Bit Of You	Chase Bryant
Wings	Little Mix
How to Love	Lil Wayne
Soon You’ll Get Better	Taylor Swift Featuring Dixie Chicks
If I Told You	Darius Rucker
What Do You Mean?	Justin Bieber
Skyscraper	Demi Lovato
Chasing The Sun	The Wanted
​out for the night	21 Savage
The Night Is Still Young	Nicki Minaj
Sit Next to Me	Foster The People
King Wizard	Kid Cudi
Fire & Desire	Drake
YAH.	Kendrick Lamar
Send My Love (To Your New Lover)	Adele
Smile	Avril Lavigne
Touchin’ Lovin’	Trey Songz Featuring Nicki Minaj
C’mon	Ke$ha
Find Your Love	Drake
I Cry	Flo Rida
My Boo	Ghost Town DJ's
Like That	Kris Wu
New Slaves	Kanye West
Hey Girl	Billy Currington
No Roots	Alice Merton
Starving	Hailee Steinfeld & Grey Featuring Zedd
I Pray	Red Marlow
What Makes You Beautiful	One Direction
Redemption	Drake
Motivation	Kelly Rowland Featuring Lil Wayne
Losin Control	Russ
Dance Again	Jennifer Lopez Featuring Pitbull
Yours If You Want It	Rascal Flatts
New Music Friday 06/24/16	Lil Wayne, Wiz Khalifa & Imagine Dragons With Logic & Ty Dolla $ign Feat. X Ambassadors
143	Bobby Brackins Featuring Ray J
Hold On, We’re Going Home	Drake Featuring Majid Jordan
Whip My Hair	WILLOW
Memories	David Guetta Featuring Kid Cudi
Codeine Dreaming	Kodak Black Featuring Lil Wayne
Closer	Tegan And Sara
Backseat	New Boyz Featuring The Cataracs & Dev
Turn the Night Up	Enrique Iglesias
Ask Me How I Know	Garth Brooks
Everyday	Logic & Marshmello
Heart Like Mine	Miranda Lambert
I Will Always Love You	Whitney Houston
I Can Take It From There	Chris Young
Every Little Thing	Russell Dickerson
Girl on Fire (Inferno Version)	Alicia Keys Featuring Nicki Minaj
Beautiful People	Ed Sheeran Featuring Khalid
Never Be the Same	Camila Cabello
Oh Santa!	Mariah Carey
​gun smoke	21 Savage
Kiss Somebody	Morgan Evans
Party Monster	The Weeknd
I THINK	Tyler, The Creator
BOSS	The Carters
Tie Me Down	New Boyz Featuring Ray J
It Girl	Jason Derulo
Haven’t Met You Yet	Michael Buble
I Want Crazy	Hunter Hayes
I Got A Car	George Strait
Earned It (Fifty Shades of Grey)	The Weeknd
Unconditionally	Katy Perry
Christmas Lights	Coldplay
Radioactive	Imagine Dragons
One Number Away	Luke Combs
Maps	Maroon 5
Midnight	Coldplay
Draco	Future
Alice	Avril Lavigne
No Heart	21 Savage & Metro Boomin
Heartbreak Warfare	John Mayer
Did It Again	Lil Tecca
I’m Gonna Love You Through It	Martina McBride
Rich	Maren Morris
Lost Boy	Ruth B
Slave to the Rhythm	Michael Jackson
Stay	Post Malone
Wake Me Up	Avicii
Sidewalks	The Weeknd Featuring Kendrick Lamar
Diplomatic Immunity	Drake
GUMMO	6ix9ine
Rocket Ship	Future
Parking Lot Party	Lee Brice
Hey, Soul Sister	Train
Drunk Last Night	Eli Young Band
One Thing Right	Marshmello & Kane Brown
Back To You	Selena Gomez
Don’t Stop (Color on the Walls)	Foster The People
Dip	Tyga & Nicki Minaj
Snapbacks & Tattoos	Driicky Graham
What If	Jason Derulo
Don’t It	Billy Currington
Love Sosa	Chief Keef
Mi Gente (Beyoncé Remix)	J Balvin & Willy William Featuring Beyonce
Quickie	Miguel
Beez In The Trap	Nicki Minaj Featuring 2 Chainz
Believe	Eminem
Till I’m Gone	Tinie Tempah Featuring Wiz Khalifa
XXX.	Kendrick Lamar Featuring U2
Summertime Magic	Childish Gambino
Prayed for You	Matt Stell
Lights Up	Harry Styles
For Free	DJ Khaled Featuring Drake
Think A Little Less	Michael Ray
My PYT	Wale
Un-Thinkable (I’m Ready)	Alicia Keys
You’re So Beautiful (Remake)	Empire Cast Featuring Jussie Smollett & Yazz
Word Crimes	"""Weird Al"" Yankovic"
This Could Be Us	Rae Sremmurd
0 to 100 / The Catch Up	Drake
Falling Down	Lil Peep & XXXTENTACION
Keep Your Head Up	Andy Grammer
Blow Me (One Last Kiss)	P!nk
6 Man	Drake
Someone Like You	Adele
Set the Fire to the Third Bar	Snow Patrol Featuring Martha Wainwright
Rake It Up	Yo Gotti Featuring Nicki Minaj
Fly Away	5 Seconds Of Summer
Let Me Love You (Until You Learn to Love Yourself)	Ne-Yo
​break up with your girlfriend, i’m bored	Ariana Grande
Father Stretch My Hands, Pt. 1	Kanye West
Jackie Chan	Tiesto & Dzeko Featuring Preme & Post Malone
Downtown	Lady Antebellum
Lose You To Love Me	Selena Gomez
Mockingbird	Rob Thomas
Firework	Katy Perry
Redneck Crazy	Tyler Farr
Medicine	Queen Naija
Singles You Up	Jordan Davis
Style	Taylor Swift
On To The Next One	Jay-Z + Swizz Beatz
Lights Come On	Jason Aldean
X	ScHoolboy Q, 2 Chainz & Saudi
Fetish	Selena Gomez Featuring Gucci Mane
Little Toy Guns	Carrie Underwood
Magic	B.o.B Featuring Rivers Cuomo
Alejandro	Lady Gaga
Head Over Boots	Jon Pardi
Shake It Out	Florence + The Machine
Honey, I’m Good.	Andy Grammer
Taking a Walk	Trippie Redd
Sexy Chick	David Guetta Featuring Akon
Helluva Life	Frankie Ballard
Untouchable	YoungBoy Never Broke Again
Baby, It’s Cold Outside	Dean Martin
Only	Nicki Minaj Featuring Drake, Lil Wayne & Chris Brown
Our Kind Of Love	Lady Antebellum
Six Feet Under	The Weeknd
The Man Who Can’t Be Moved	The Script
How Not To	Dan + Shay
Mrs. Right	Mindless Behavior Featuring Diggy
Everything Has Changed	Taylor Swift Featuring Ed Sheeran
This Feeling	The Chainsmokers Featuring Kelsea Ballerini
Out of My Head	Lupe Fiasco Featuring Trey Songz
On My Mind	Ellie Goulding
The Show Goes On	Lupe Fiasco
Story of My Life	One Direction
I Like It	Enrique Iglesias Featuring Pitbull
Road Less Traveled	Lauren Alaina
Slow Motion	Trey Songz
Queen of Mean	Sarah Jeffery
Get Me Some of That	Thomas Rhett
​​breathin	Ariana Grande
False Alarm	The Weeknd
Institutionalized	Kendrick Lamar Featuring Bilal, Anna Wise & Snoop Dogg
Hit The Quan	iLoveMemphis
La La Land	Bryce Vine Featuring YG
Novacane	Frank Ocean
Cuban Links	Rod Wave & Kevin Gates
Weston Road Flows	Drake
​all my friends	21 Savage
Needed Me	Rihanna
Racks	YC Featuring Future
Top of the World	Tim McGraw
Often	The Weeknd
Whatever She’s Got	David Nail
No Love	Eminem Featuring Lil Wayne
Humble and Kind	Tim McGraw
Coming Home	Keith Urban Featuring Julia Michaels
Bom Bidi Bom	Nick Jonas & Nicki Minaj
Masterpiece	Jessie J
Higher (Travie McCoy Remix)	Taio Cruz Featuring Travie McCoy
Everyday We Lit	YFN Lucci Featuring PnB Rock
Tunnel Vision	Kodak Black
Show Me	Kid Ink Featuring Chris Brown
Drinking Class	Lee Brice
I Dreamed a Dream	Glee Cast Featuring Idina Menzel
Determinate	Bridgit Mendler, Adam Hicks, Naomi Scott & Hayley Kiyoko
Did It On’em	Nicki Minaj
Mercy	Kanye West, Big Sean, Pusha T, 2 Chainz
​xanny	Billie Eilish
Look Alive	BlocBoy JB Featuring Drake
Me Enamoré	Shakira
Dancing Crazy	Miranda Cosgrove
HandClap	Fitz And The Tantrums
Vice	Miranda Lambert
Take Me or Leave Me	Glee Cast
No Me Conoce (Remix)	Jhay Cortez, J Balvin & Bad Bunny
Bubble Butt	Major Lazer Featuring Bruno Mars, Tyga & Mystic
Bon Appétit	Katy Perry Featuring Migos
Mirrors	Justin Timberlake
Strip That Down	Liam Payne Featuring Quavo
Home	Phillip Phillips
Sledgehammer	Fifth Harmony
Scary Monsters and Nice Sprites	Skrillex
Hey Brother	Avicii
I Love It	Kanye West & Lil Pump
No Type	Rae Sremmurd
Panini	Lil Nas X
Misery	Glee Cast
Take a Walk	Passion Pit
Come Back Song	Darius Rucker
Footloose	Blake Shelton
223's	YNW Melly & 9lokknine
Kings and Queens	Thirty Seconds To Mars
Too Close	Alex Clare
Little Red Wagon	Miranda Lambert
White Christmas	Bing Crosby
Hello	Adele
​bury a friend	Billie Eilish
Not Nice	PARTYNEXTDOOR
Neva End	Future
Fifteen	Taylor Swift
Any Ol’ Barstool	Jason Aldean
​in my head	Ariana Grande
Work from Home	Fifth Harmony Featuring Ty Dolla $ign
What’s My Name?	Rihanna Featuring Drake
Miss Me	Drake Featuring Lil Wayne
Lookin’ for that Girl	Tim McGraw
Falling	Trevor Daniel
Red Room	Offset
The Catalyst	Linkin Park
If I Die Young	The Band Perry
You Stay	DJ Khaled Featuring Meek Mill, J Balvin, Lil Baby & Jeremih
Who I Am with You	Chris Young
Turn On the Lights	Future
Never Gonna Leave This Bed	Maroon 5
Nightmare	Avenged Sevenfold
​the remedy for a broken heart (why am I so in love)	XXXTENTACION
Kiss Me Kiss Me	5 Seconds Of Summer
Brokenhearted	Karmin
Break	Three Days Grace
NASA	Ariana Grande
U Guessed It (Remix)	OG Maco Featuring 2 Chainz
Roger That	Young Money
Water Under the Bridge	Adele
God, Your Mama, and Me	Florida Georgia Line Featuring Backstreet Boys
Strip Me	Natasha Bedingfield
Do You Mind	DJ Khaled Featuring Nicki Minaj, Chris Brown, August Alsina, Jeremih, Future & Rick Ross
​i’m so tired...	Lauv & Troye Sivan
Uprising	Muse
Self Control	YoungBoy Never Broke Again
All Girls Are the Same	Juice WRLD
Life Changes	Thomas Rhett
Nothin’ Like You	Dan + Shay
MotorSport	Migos, Nicki Minaj & Cardi B
The 100 Best Country Songs Of All Time	Tim McGraw With Taylor Swift
You Don’t Know Her Like I Do	Brantley Gilbert
Nobody to Blame	Chris Stapleton
Fine By Me	Andy Grammer
I Met a Girl	William Michael Morgan
American Honey	Lady Antebellum
Shots	Imagine Dragons
One More Night	Maroon 5
Love Like Woe	The Ready Set
Love Wins	Carrie Underwood
Paper Rings	Taylor Swift
Still Here	Drake
Red Solo Cup	Toby Keith
Pills & Automobiles	Chris Brown Featuring Yo Gotti, A Boogie Wit da Hoodie & Kodak Black
The Greatest Show	Hugh Jackman, Keala Settle, Zac Efron, Zendaya & The Greatest Showman Ensemble
Thrift Shop	Macklemore & Ryan Lewis Featuring Wanz
Life Is Worth Living	Justin Bieber
Intro	J. Cole
Ghost	Ella Henderson
Mary, Did You Know?	Pentatonix
Now & Forever	Drake
Everything to Me	Monica
​​i	Lil Skies
Light It Up (Remix)	Major Lazer Featuring Nyla & Fuse ODG
Just Hold On	Steve Aoki & Louis Tomlinson
Love Yourself	Justin Bieber
On Fire	Lil Wayne
Show Yourself	Idina Menzel & Evan Rachel Wood
Dive	Ed Sheeran
Lalala	Y2K & bbno$
When Doves Cry	Prince
I Got the Keys	DJ Khaled Featuring Jay Z & Future
Unusual	Trey Songz Featuring Drake
IGOR’S THEME	Tyler, The Creator
King’s Dead	Jay Rock, Kendrick Lamar, Future & James Blake
Fine China	Future & Juice WRLD
Round Here Buzz	Eric Church
Love You Too Late	Cole Swindell
Let You Down	NF
Beautiful	Carly Rae Jepsen Featuring Justin Bieber
Heart Skips a Beat (Remix)	Olly Murs Featuring Chiddy Bang
What About Love	Austin Mahone
It’s Goin’ Down	Descendants 2 Cast
Roll Up	Wiz Khalifa
Kinfolks	Sam Hunt
Bang My Head (Remix)	David Guetta Featuring Sia & Fetty Wap
Sunrise, Sunburn, Sunset	Luke Bryan
Cross Me	Ed Sheeran Featuring Chance The Rapper & PnB Rock
Living	Dierks Bentley
Tennessee Rain	Addison Agen
See You Tonight	Scotty McCreery
Purple Rain	Prince And The Revolution
Treasure	Bruno Mars
New Music Friday 12/16/16	Zayn / Taylor Swift
You & I (Nobody in the World)	John Legend
How We Do (Party)	Rita Ora
Rumor	Lee Brice
Shake	Jesse McCartney
Perfect Illusion	Lady Gaga
Neon	Chris Young
Pure Cocaine	Lil Baby
Good for You	Selena Gomez Featuring A$AP Rocky
Gonna	Blake Shelton
Lord Knows	Meek Mill
No Smoke	YoungBoy Never Broke Again
You Know You Like It	DJ Snake & AlunaGeorge
Don’t Stop	5 Seconds Of Summer
Sick Boy	The Chainsmokers
I Like It	Cardi B, Bad Bunny & J Balvin
Fall	Eminem
80s Mercedes	Maren Morris
Everything is AWESOME!!!	Tegan And Sara Featuring The Lonely Island
Human	Rag'n'Bone Man
Woah	Lil Baby
Wildest Dreams	Taylor Swift
Am I the Only One	Dierks Bentley
Change Lanes	Kevin Gates
Black and Yellow	Wiz Khalifa
Rich As Hell	YoungBoy Never Broke Again
Ransom	Lil Tecca
Let Me Love You	Ariana Grande Featuring Lil Wayne
Hail to the King	Avenged Sevenfold
Adore You	Miley Cyrus
Eyes on You	Chase Rice
Loud	Mac Miller
Mama Said	Lukas Graham
Sleigh Ride	The Ronettes
Topanga	Trippie Redd
Even Though I’m Leaving	Luke Combs
Hey Mama	David Guetta Featuring Nicki Minaj, Bebe Rexha & Afrojack
Feels	Calvin Harris Featuring Pharrell Williams, Katy Perry & Big Sean
Self Care	Mac Miller
Love Runs Out	OneRepublic
Airplanes	B.o.B Featuring Hayley Williams
Song About a Girl	Eric Paslay
In My Head	Jason Derulo
Hope You Get Lonely Tonight	Cole Swindell
That’s On Me	Yella Beezy
Hometown Girl	Josh Turner
I Wanna Go	Britney Spears
Attention	Charlie Puth
Somewhere On a Beach	Dierks Bentley
Billie Jean	Michael Jackson
If I Could Fly	One Direction
How Many Drinks?	Miguel
Big Shot	Kendrick Lamar & Travis Scott
Dirt	Florida Georgia Line
Somebody That I Used to Know	Glee Cast
This Summer’s Gonna Hurt Like a Motherfucker	Maroon 5
Cryin’ For Me (Wayman’s Song)	Toby Keith
Somebody That I Used To Know (The Voice Performance)	Christina Grimmie & Adam Levine
Ring	Cardi B Featuring Kehlani
Beachin’	Jake Owen
Olivia	One Direction
It’s You	Ali Gatie
Vete	Bad Bunny
Weak	AJR
Down	Marian Hill
Chains	Nick Jonas
Crazy Town	Jason Aldean
GDFR	Flo Rida Featuring Sage The Gemini & Lookas
Days of Gold	Jake Owen
Paper Doll	John Mayer
The Heart of Dixie	Danielle Bradbery
A Little Bit Stronger	Sara Evans
The Other Side	Jason Derulo
Prayer in C (Robin Schulz Radio Edit)	Lillywood & Robin Schulz
Record Year	Eric Church
She’s Kinda Hot	5 Seconds Of Summer
Do I Wanna Know?	Arctic Monkeys
Mean To Me	Brett Eldredge
Feeling Myself	Nicki Minaj Featuring Beyonce
Down to the Honkytonk	Jake Owen
Kick the Dust Up	Luke Bryan
Lonely Boy	The Black Keys
One Thing	One Direction
Leave You Alone	Young Jeezy Featuring Ne-Yo
Let Me Go	Hailee Steinfeld & Alesso Featuring Florida Georgia Line & Watt
Never Say Never	Justin Bieber Featuring Jaden Smith
Partition	Beyonce
Different for Girls	Dierks Bentley Featuring Elle King
Burnin’ It Down	Jason Aldean
The Fox (What Does the Fox Say?)	Ylvis
False God	Taylor Swift
Young, Wild & Free	Snoop Dogg & Wiz Khalifa Featuring Bruno Mars
Best Day of My Life	American Authors
It’s the Most Wonderful Time of the Year	Andy Williams
Moolah	Young Greatness
Caroline	Amine
EARFQUAKE	Tyler, The Creator
V.S.O.P.	K. Michelle
You Be Killin Em	Fabolous
First of the Year (Equinox)	Skrillex
In Control	YoungBoy Never Broke Again
Honest	Future
​bad idea	Ariana Grande
Best Friend’s Brother	Victorious Cast Featuring Victoria Justice
Know Yourself	Drake
Rumour Has It / Someone Like You	Glee Cast
Promise	Kid Ink Featuring Fetty Wap
Love Me Harder	Ariana Grande & The Weeknd
Litty	Meek Mill Featuring Tory Lanez
Dust	Eli Young Band
All About That Bass	Meghan Trainor
Ain’t Back Yet	Kenny Chesney
Wide Awake	Katy Perry
Dark Horse	Katy Perry Featuring Juicy J
Parachute	Chris Stapleton
Stitches	Shawn Mendes
The Ways	Khalid & Swae Lee
You Broke Up with Me	Walker Hayes
Teenage Dream	Katy Perry
Him & I	G-Eazy & Halsey
Rock That Body	The Black Eyed Peas
Good Thing	Sage The Gemini Featuring Nick Jonas
Applause	Lady Gaga
My Type	Saweetie
Saturday Nights REMIX	Khalid & Kane Brown
BILLY	6ix9ine
Die a Happy Man	Thomas Rhett
Rockabye	Clean Bandit Featuring Sean Paul & Anne-Marie
Trumpets	Jason Derulo
7 Years	Lukas Graham
Cowboys And Angels	Dustin Lynch
Far Away	Marsha Ambrosius
Red Lights	Tiesto
We’ll Be a Dream	WE the Kings Featuring Demi Lovato
Gone, Gone, Gone	Phillip Phillips
Hey	Lil Jon Featuring 3OH!3
No Sense	Justin Bieber Featuring Travi$ Scott
Wu-Tang Forever	Drake
Southside	Lil Baby
Window Pain (Outro)	J. Cole
Gold on the Ceiling	The Black Keys
Oh Love	Green Day
Rain Over Me	Pitbull Featuring Marc Anthony
Na Na	Trey Songz
Come Wake Me Up	Rascal Flatts
Down On Me	Jeremih Featuring 50 Cent
Two Black Cadillacs	Carrie Underwood
TKO	Justin Timberlake
Beers Ago	Toby Keith
Show Out	Juicy J Featuring Big Sean & Young Jeezy
Runaway Baby	Bruno Mars
Free	Zac Brown Band
Baby	Lil Baby & DaBaby
Welcome to the Party	Diplo, French Montana & Lil Pump Featuring Zhavia Ward
Alone Together	Fall Out Boy
The Blacker the Berry	Kendrick Lamar
My First Kiss	3OH!3 Featuring Ke$ha
Price Tag	Jessie J Featuring B.o.B
Oceans (Where Feet May Fail)	Hillsong UNITED
Promises	Calvin Harris & Sam Smith
Fresh Eyes	Andy Grammer
We Were Us	Keith Urban And Miranda Lambert
Miss Me More	Kelsea Ballerini
Hype	Drake
Stay with Me	Sam Smith
679	Fetty Wap Featuring Remy Boyz
Jealous	Nick Jonas
Close Friends	Lil Baby
Night Changes	One Direction
Turning Tables	Adele
​God is a woman	Ariana Grande
​coffee	Miguel
Sign of the Times	Harry Styles
Candles	Glee Cast
Imma Be	The Black Eyed Peas
A.M.	One Direction
Out of the Woods	Taylor Swift
Love on the Brain	Rihanna
Round Of Applause	Waka Flocka Flame Featuring Drake
The Fighter	Keith Urban Featuring Carrie Underwood
Too Much Sauce	DJ ESCO Featuring Future & Lil Uzi Vert
First Love	Jennifer Lopez
Without Me	Halsey
Hey Baby (Drop It to the Floor)	Pitbull Featuring T-Pain
I Just Had Sex	The Lonely Island Featuring Akon
Voices	Chris Young
Downtown	Macklemore & Ryan Lewis Featuring Eric Nally, Melle Mel, Kool Moe Dee & Grandmaster Caz
Castaway	Zac Brown Band
Emotionless	Drake
Gotta Have It	Jay Z Kanye West
JAPAN	Famous Dex
Uma Thurman	Fall Out Boy
Don’t Drop That Thun Thun	The FiNATTiCZ
Propuesta Indecente	Romeo Santos
Never Really Over	Katy Perry
Climax	Usher
Party in the U.S.A.	Miley Cyrus
OTW	DJ Luke Nasty
Birthday Song	2 Chainz Featuring Kanye West
Knee Deep	Zac Brown Band Featuring Jimmy Buffett
Lovin’ You Is Fun	Easton Corbin
PPAP (Pen Pineapple Apple Pen) (Long Version)	PIKOTARO
Dirty Laundry	Carrie Underwood
RUNNING OUT OF TIME	Tyler, The Creator
Catch My Breath	Kelly Clarkson
DJ Got Us Fallin’ in Love	Usher Featuring Pitbull
Roller Coaster	Luke Bryan
Yacht Club	Lil Yachty Featuring Juice WRLD
Walking on a Dream	Empire Of The Sun
Behind Barz	Drake
Mercy	Dave Matthews Band
Boyz-n-the Hood	Eazy-E
Round & Round	Selena Gomez & The Scene
Goodbye In Her Eyes	Zac Brown Band
Watch Me	Silento
Give In To Me	Garrett Hedlund & Leighton Meester
Love Faces	Trey Songz
I Like the Sound of That	Rascal Flatts
Elastic Heart	Sia
DNA	BTS
Waves	Mr. Probz
I Got Nothin’	Darius Rucker
A Guy With a Girl	Blake Shelton
I Lived It	Blake Shelton
Empire State of Mind (Part II) Broken Down	Alicia Keys
Man of tHe Year	ScHoolboy Q
Should’ve Been Us	Tori Kelly
BRACKETS	J. Cole
Boom	Snoop Dogg Featuring T-Pain
Round Here	Florida Georgia Line
Best Song Ever	One Direction
Ruin My Life	Zara Larsson
How Will I Know	Whitney Houston
Sugar	Robin Schulz Featuring Francesco Yates
Both	Gucci Mane Featuring Drake
Country Songs about Drinking Alcohol	Dustin Lynch
Check It Out	will.i.am & Nicki Minaj
​arms	Christina Perri
Ghostface Killers	21 Savage, Offset & Metro Boomin Featuring Travis Scott
Liquor	Chris Brown
Level Up	Ciara
Say You Won’t Let Go	James Arthur
Chill Bill	Rob $tone Featuring J. Davi$ & Spooks
Holding You Down (Goin’ In Circles)	Jazmine Sullivan
Merry Go ’Round	Kacey Musgraves
Versace on the Floor	Bruno Mars
Saved	Ty Dolla $ign Featuring E-40
Throw Sum Mo	Rae Sremmurd Featuring Nicki Minaj & Young Thug
Lover, Lover	Jerrod Niemann
Cop Car	Keith Urban
Use Somebody	Kings Of Leon
This Is How We Do	Katy Perry
Love Me Again	John Newman
Really Don’t Care	Demi Lovato Featuring Cher Lloyd
The Long Way	Brett Eldredge
Spoil My Night	Post Malone Featuring Swae Lee
Light It Up	Luke Bryan
Aston Martin Music	Rick Ross Featuring Drake & Chrisette Michele
Secreto	Anuel AA & Karol G
Don’t Call Me Up	Mabel
Midnight Memories	One Direction
For You, and Your Denial	Yellowcard
Where Have You Been	Rihanna
Armed & Dangerous	Juice WRLD
Drop It Low	Ester Dean Featuring Chris Brown
No Brainer	DJ Khaled Featuring Justin Bieber, Chance The Rapper & Quavo
Hell On The Heart	Eric Church
Last Christmas	Ariana Grande
Strip It Down	Luke Bryan
Spotlight	Gucci Mane Featuring Usher
Wish You Were Here	Avril Lavigne
Sail	AWOLNATION
Do What U Want	Lady Gaga Featuring R. Kelly
Marvin & Chardonnay	Big Sean Featuring Kanye West & Roscoe Dash
Questions	Chris Brown
All the Right Moves	OneRepublic
Shake It Off	Taylor Swift
Ready or Not	Bridgit Mendler
Good Girls	5 Seconds Of Summer
Night’s On Fire	David Nail
West Coast	Lana Del Rey
Black Magic	Little Mix
Mean	Taylor Swift
Baby Shark	Pinkfong
Papi	Jennifer Lopez
Sure Be Cool If You Did	Blake Shelton
F&N	Future
Night Train	Jason Aldean
Go Flex	Post Malone
X (EQUIS)	Nicky Jam x J Balvin
Break Up in the End	Cole Swindell
Water	Brad Paisley
Young Dumb & Broke	Khalid
Hot	Young Thug Featuring Gunna
Farmer’s Daughter	Rodney Atkins
Break Up With Him	Old Dominion
Point At You	Justin Moore
Lighters	Bad Meets Evil Featuring Bruno Mars
​break da law	21 Savage
State of Grace	Taylor Swift
I’m on One	DJ Khaled Featuring Drake, Rick Ross & Lil Wayne
I’ll Name the Dogs	Blake Shelton
Radioactive	Kings Of Leon
Rude Boy	Rihanna
Long Live A$AP	A$AP Rocky
Happy	Pharrell Williams
#Beautiful	Mariah Carey Featuring Miguel
Baby	Glee Cast
Teach Me How to Dougie	Cali Swag District
Don’t Stop the Party	The Black Eyed Peas
Company	Justin Bieber
Beer Money	Kip Moore
When I See This Bar	Kenny Chesney
Dancin’ Away With My Heart	Lady Antebellum
Handsome and Wealthy	Migos
Runaways	The Killers
Kiss	Prince And The Revolution
No Role Modelz	J. Cole
Almost Is Never Enough	Ariana Grande & Nathan Sykes
Changed It	Nicki Minaj & Lil Wayne
Star of the Show	Thomas Rhett
Where Them Girls At	David Guetta Featuring Flo Rida & Nicki Minaj
You Should Be Here	Cole Swindell
RAP DEVIL	Machine Gun Kelly
Angel Eyes	Love And Theft
For You	Keith Urban
Lay Me Down	Sam Smith
Arsonal vs K-Shine	Usher & Michelle Chamuel
Rewrite the Stars	Zac Efron & Zendaya
Red Light	David Nail
Hello, Goodbye	Glee Cast
All the Pretty Girls	Kenny Chesney
Friday Night	Eric Paslay
Turn Down For What	DJ Snake & Lil Jon
Church Bells	Carrie Underwood
Whatcha Say	Jason Derulo
When A Woman Loves	R. Kelly
Shotta Flow	NLE Choppa
Millionaire	Chris Stapleton
Hustle Hard	Ace Hood
ROXANNE	Arizona Zervas
She Got the Best of Me	Luke Combs
Make Me Wanna	Thomas Rhett
One Less Lonely Girl	Justin Bieber
Adventure of a Lifetime	Coldplay
Loving You Easy	Zac Brown Band
Turn On The Radio	Reba
Pretty Good At Drinkin’ Beer	Billy Currington
Live While We’re Young	One Direction
Immortal	J. Cole
Sunshine & Whiskey	Frankie Ballard
$ave Dat Money	Lil Dicky Featuring Fetty Wap & Rich Homie Quan
I Drive Your Truck	Lee Brice
How Country Feels	Randy Houser
Wait	Maroon 5
How Do You Sleep?	Sam Smith
24K Magic	Bruno Mars
Ridin’ Solo	Jason Derulo
Wicked	Future
Come Over	Kenny Chesney
Héroe Favorito	Romeo Santos
What Do You Want	Jerrod Niemann
Over	Drake
Crawling Back to You	Daughtry
Gentleman	PSY
WHAT’S GOOD	Tyler, The Creator
I’m the Plug	Drake & Future
Chainsaw	The Band Perry
It’s Time	Imagine Dragons
Try	Colbie Caillat
Everything 1K	Kodak Black
Beware	Big Sean Featuring Lil Wayne & Jhene Aiko
High School	Nicki Minaj Featuring Lil Wayne
Gonna Wanna Tonight	Chase Rice
Bait A Hook	Justin Moore
Wishing	DJ Drama Featuring Chris Brown, Skeme & Lyquin
Darte un Beso	Prince Royce
Meek Mill Freestyles on Flex (2017) | Freestyle #068	Lauren Duski
Trip	Ella Mai
Hangin’ On	Chris Young
Stronger (What Doesn’t Kill You)	Kelly Clarkson
Grass Ain’t Greener	Chris Brown
God’s Plan	Drake
Take Your Time	Sam Hunt
Back to Sleep	Chris Brown
Press	Cardi B
Jealous	DJ Khaled Featuring Chris Brown, Lil Wayne & Big Sean
CRZY	Kehlani
Want U Back	Cher Lloyd
Hard To Love	Lee Brice
Club Can’t Handle Me	Flo Rida Featuring David Guetta
One Time	Justin Bieber
I Like It Like That	Hot Chelle Rae Featuring New Boyz
You Make It Easy	Jason Aldean
Runnin’ Outta Moonlight	Randy Houser
Baby	Justin Bieber Featuring Ludacris
Knockin’ Boots	Luke Bryan
White Iverson	Post Malone
Fearless	Taylor Swift
Rewind	Rascal Flatts
Firework	Glee Cast
Roar	Katy Perry
Gettin’ Over You	David Guetta & Chris Willis Featuring Fergie & LMFAO
Classic	MKTO
Only Time	Enya
Whiskey Glasses	Morgan Wallen
Could It Be	Charlie Worsham
Black Beatles	Rae Sremmurd Featuring Gucci Mane
Heart on Ice	Rod Wave
X	21 Savage & Metro Boomin Featuring Future
High End	Chris Brown Featuring Future & Young Thug
Dibs	Kelsea Ballerini
Formation	Beyonce
​goosebumps	Travis Scott
Crash My Party	Luke Bryan
Been You	Justin Bieber
SING	Glee Cast
Lips Are Movin	Meghan Trainor
Slide	Calvin Harris Featuring Frank Ocean & Migos
It Goes Like This	Thomas Rhett
Climb Every Mountain	Jordan Smith
The Weekend	SZA
Fix	Chris Lane
It’s a Vibe	2 Chainz Featuring Ty Dolla $ign, Trey Songz & Jhene Aiko
Eyes Wide Open	Gotye
I Made It (Cash Money Heroes)	Kevin Rudolf Featuring Birdman, Jay Sean, & Lil Wayne
Rap Genius Trends: 2014	Young Money Featuring Drake
Robbery	Juice WRLD
Never Forget You	Zara Larsson & MNEK
Look at You	Big & Rich
Like A Wrecking Ball	Eric Church
Camouflage	Brad Paisley
I Love It	Icona Pop Featuring Charli XCX
GOD.	Kendrick Lamar
DNA.	Kendrick Lamar
Heathens	twenty one pilots
White Walls	Macklemore & Ryan Lewis Featuring ScHoolboy Q & Hollis
Deja Vu	J. Cole
Just Breathe	Pearl Jam
Ball For Me	Post Malone Featuring Nicki Minaj
Hit or Miss	Jacob Sartorius
Love Don’t Die	The Fray
Confession	Florida Georgia Line
Coming Home	Diddy - Dirty Money Featuring Skylar Grey
​all the good girls go to hell	Billie Eilish
24/7	Meek Mill Featuring Ella Mai
There Goes My Baby	Usher
Wet Dreamz	J. Cole
Something to Do with My Hands	Thomas Rhett
Feel Like A Rock Star	Kenny Chesney & Tim McGraw
Wonderland	Taylor Swift
PRIDE.	Kendrick Lamar
I’m Different	2 Chainz
Not Over You	Gavin DeGraw
Dark Times	The Weeknd Featuring Ed Sheeran
Bobby Bitch	Bobby Shmurda
No Lie	2 Chainz Featuring Drake
Only Girl (In the World)	Rihanna
Women Lie, Men Lie	Yo Gotti Featuring Lil Wayne
Crooked Smile	J. Cole Featuring TLC
Please Don’t Go	Mike Posner
Wobble	V.I.C.
Little Lion Man	Mumford & Sons
We Were	Keith Urban
Turn Me On	David Guetta Featuring Nicki Minaj
The Story of O.J.	JAY-Z
Kiss You In The Morning	Michael Ray
Jerry Sprunger	Tory Lanez & T-Pain
Supplies	Justin Timberlake
April 2016 Album Release Calendar	Javier Colon
Neighbors Know My Name	Trey Songz
Purple Lamborghini	Skrillex & Rick Ross
NBAYOUNGBOAT	Lil Yachty Featuring NBA YoungBoy
Sing!	Ed Sheeran
Misery	Maroon 5
Swalla	Jason Derulo Featuring Nicki Minaj & Ty Dolla $ign
Straight Outta Compton	N.W.A
Honest	The Chainsmokers
Liability	Lorde
Make No Sense	YoungBoy Never Broke Again
Hate Me	Ellie Goulding & Juice WRLD
My House	Flo Rida
Solo	Clean Bandit Featuring Demi Lovato
On Top of the World	Imagine Dragons
Dura	Daddy Yankee
A Thousand Years	Christina Perri
Angel	Akon
2 Reasons	Trey Songz Featuring T.I.
Young & Crazy	Frankie Ballard
Come & Get It	Selena Gomez
If I Can’t Have You	Shawn Mendes
Bulletproof	La Roux
Headlines	Drake
Domino	Jessie J
Swang	Rae Sremmurd
How Far I’ll Go	Auli'i Cravalho
Rhythm of Love	Plain White T's
Sex Therapy	Robin Thicke
Young & Gettin’ It	Meek Mill Featuring Kirko Bangz
Time	NF
Get Along	Kenny Chesney
Backroad Song	Granger Smith
Tonight (I’m Lovin’ You)	Enrique Iglesias Featuring Ludacris & DJ Frank E
Paradise	Coldplay
Delicate	Taylor Swift
I Hit It First	Ray J Featuring Bobby Brackins
Paparazzi	Lady Gaga
Nobody’s Perfect	J. Cole Featuring Missy Elliott
Love Me Now	John Legend
Higher	DJ Khaled Featuring Nipsey Hussle & John Legend
7 rings	Ariana Grande
Victorious	Panic! At The Disco
Bartender	Lady Antebellum
J. Cole - FRIENDS ft. kiLL edward (Tradução)	J. Cole Featuring kiLL edward
Cowboy Casanova	Carrie Underwood
Rap God	Eminem
Loco Contigo	DJ Snake, J. Balvin & Tyga
Good Life	OneRepublic
BOP	DaBaby
Love Like Crazy	Lee Brice
My Old Man	Zac Brown Band
Castle on the Hill	Ed Sheeran
Levels	Nick Jonas
Kendrick Lamar - LOVE. (ft. Zacari) (Traduction Française)	Kendrick Lamar Featuring Zacari
Barbie Dreams	Nicki Minaj
If I Didn’t Have You	Thompson Square
Put a Date on It	Yo Gotti Featuring Lil Baby
Summertime Sadness (Cedric Gervais Remix)	Lana Del Rey & Cedric Gervais
3	Britney Spears
Home	Dierks Bentley
Flicka Da Wrist	Chedda Da Connect
Up All Night	Jon Pardi
Feel It Still	Portugal. The Man
Whatever It Takes	Imagine Dragons
The Way I Am	Charlie Puth
Move	Luke Bryan
Dancing with a Stranger	Sam Smith & Normani
It Kills Me	Melanie Fiona
Born This Way	Lady Gaga
This Is Country Music	Brad Paisley
Swimming Pools (Drank)	Kendrick Lamar
Acapella	Karmin
Yoü and I	Lady Gaga
How Deep Is Your Love	Calvin Harris & Disciples
Google Translate Sings: “Despacito” by Luis Fonsi & Daddy Yankee ft. Justin Bieber	Luis Fonsi & Daddy Yankee Featuring Justin Bieber
Stay A Little Longer	Brothers Osborne
You Need To Calm Down	Taylor Swift
Yours	Russell Dickerson
Rude	MAGIC!
Lemonade	Gucci Mane
Something Just Like This	The Chainsmokers & Coldplay
New Romantics	Taylor Swift
Every Storm (Runs Out of Rain)	Gary Allan
Everything I Didn’t Say	5 Seconds Of Summer
Bleed Red	Ronnie Dunn
Get Your Shine On	Florida Georgia Line
Made in the USA	Demi Lovato
Flashlight	Jessie J
Turning Tables	Glee Cast Featuring Gwyneth Paltrow
Fastest Girl In Town	Miranda Lambert
Counting Stars	OneRepublic
Believe Me	Lil Wayne Featuring Drake
Cake	Flo Rida & 99 Percent
Criminal	Britney Spears
Some Nights	fun.
I Got the Boy	Jana Kramer
Sweet Annie	Zac Brown Band
People Like Us	Kelly Clarkson
Talk	Khalid
California Gurls	Katy Perry Featuring Snoop Dogg
Daylight	Maroon 5
Diana	One Direction
Kevin’s Heart	J. Cole
You’re Welcome	Dwayne Johnson
All I Do Is Win	DJ Khaled Featuring T-Pain, Ludacris, Snoop Dogg & Rick Ross
Something New	Wiz Khalifa Featuring Ty Dolla $ign
Stay	Zedd & Alessia Cara
Pop Out	Polo G Featuring Lil Tjay
Gyalchester	Drake
Marvin Gaye	Charlie Puth Featuring Meghan Trainor
We Back	Jason Aldean
You Say	Lauren Daigle
Love Ain’t	Eli Young Band
Brave	Sara Bareilles
Love Me More	Trippie Redd
Blunt Blowin’	Lil Wayne
Rubbin off the Paint	YBN Nahmir
Your Love is My Drug	Ke$ha
Say Something	A Great Big World & Christina Aguilera
Leave Em Alone	Layton Greene, Lil Baby, City Girls & PnB Rock
Stolen Dance	Milky Chance
Otis	Jay Z Kanye West Featuring Otis Redding
Last Shot	Kip Moore
Legends	Kelsea Ballerini
The Ones That Didn’t Make It Back Home	Justin Moore
Yes Indeed	Lil Baby & Drake
Skyfall	Adele
Raised on Country	Chris Young
Suit & Tie	Justin Timberlake Featuring JAY Z
Wicked Games	The Weeknd
Mixed Personalities	YNW Melly Featuring Kanye West
Bring It Back	Travis Porter
Losing Sleep	Chris Young
Baby Be My Love Song	Easton Corbin
Save It For A Rainy Day	Kenny Chesney
The Heart Wants What It Wants	Selena Gomez
How Long	Charlie Puth
Deuces	Chris Brown Featuring Tyga & Kevin McCall
Don’t Start Now	Dua Lipa
From a Table Away	Sunny Sweeney
Never Recover	Lil Baby & Gunna Featuring Drake
Blue Ain’t Your Color	Keith Urban
Little Red Corvette	Prince
​broken	lovelytheband
Hurricane	Luke Combs
No Guidance	Chris Brown Featuring Drake
Berzerk	Eminem
Erase Me	Kid Cudi Featuring Kanye West
Sangria Wine	Pharrell Williams x Camila Cabello
Lonely Child	YoungBoy Never Broke Again
New Americana	Halsey
Weather the Storm	DJ Khaled Featuring Meek Mill & Lil Baby
U Smile	Justin Bieber
Death	Trippie Redd Featuring DaBaby
Confessions of a Dangerous Mind	Logic
Greatest Love of All	Whitney Houston
Everyday	Ariana Grande Featuring Future
Somethin’ ’Bout a Truck	Kip Moore
Whatever You Need	Meek Mill Featuring Chris Brown & Ty Dolla $ign
Summer	Calvin Harris
Shot for Me	Drake
Love Done Gone	Billy Currington
Safe and Sound	Capital Cities
Better	Khalid
Don’t Call Me Angel (Charlie’s Angels)	Ariana Grande, Miley Cyrus & Lana Del Rey
Slow Me Down	Sara Evans
Colder Weather	Zac Brown Band
Gold	Kiiara
Tip Toe	Roddy Ricch Featuring A Boogie Wit da Hoodie
Heartache Medication	Jon Pardi
Ex’s & Oh’s	Elle King
​sweetener	Ariana Grande
Life After You	Daughtry
My Last	Big Sean Featuring Chris Brown
All That Matters	Justin Bieber
Bitch, Don’t Kill My Vibe	Kendrick Lamar
Storm Warning	Hunter Hayes
Black Skinhead	Kanye West
We No Speak Americano	Yolanda Be Cool & Dcup
John Cougar, John Deere, John 3:16	Keith Urban
I Knew You Were Trouble	Taylor Swift
According to You	Orianthi
One Man Can Change the World	Big Sean Featuring Kanye West & John Legend
Somebody	Internet Money, Lil Tecca & A Boogie Wit da Hoodie
More Girls Like You	Kip Moore
Thru Your Phone	Cardi B
Tennis Court	Lorde
Window Seat	Erykah Badu
Beating Heart	Ellie Goulding
Promises	NERO
Love You Like A Love Song	Selena Gomez & The Scene
Feel Again	OneRepublic
1400 / 999 Freestyle	Trippie Redd Featuring Juice WRLD
None of Your Concern	Jhene Aiko Featuring Big Sean
Hey Pretty Girl	Kip Moore
I Fall Apart	Post Malone
2U	David Guetta Featuring Justin Bieber
IDGAF	Dua Lipa
Cake By the Ocean	DNCE
Walk	Foo Fighters
Say Amen (Saturday Night)	Panic! At The Disco
Pour It Up	Rihanna
Pusher Love Girl	Justin Timberlake
Papers	Usher
Play That Song	Train
Foldin Clothes	J. Cole
INTRO	DaBaby
At My Best	Machine Gun Kelly Featuring Hailee Steinfeld
Pray For Me	The Weeknd & Kendrick Lamar
The Fighter	Gym Class Heroes Featuring Ryan Tedder
Drip Too Hard	Lil Baby & Gunna
Anaconda	Nicki Minaj
Mr. Misunderstood	Eric Church
Cuando Me Enamoro	Enrique Iglesias Featuring Juan Luis Guerra
Most People Are Good	Luke Bryan
Don’t Go Breaking My Heart	Backstreet Boys
Ballin’	Young Jeezy Featuring Lil Wayne
Energy	Drake
Start wit Me	Roddy Ricch & Gunna
Come Away to the Water	Maroon 5 Featuring Rozzi Crane
Do I	Luke Bryan
Setting the World on Fire	Kenny Chesney Featuring P!nk
Sleep Without You	Brett Young
We Are Never Ever Getting Back Together	Taylor Swift
​changes	XXXTENTACION
Break Up in a Small Town	Sam Hunt
​hot girl bummer	blackbear
Halfway Gone	Lifehouse
Never Gonna Be Alone	Nickelback
No Idea	Don Toliver
Take a Back Road	Rodney Atkins
Cry Pretty	Carrie Underwood
Sex with Me	Rihanna
Closer (The Chainsmokers & Halsey Cover)	The Chainsmokers Featuring Halsey
Roll With It	Easton Corbin
Ooh La La	Britney Spears
Just The Way You Are	Bruno Mars
We Owned The Night	Lady Antebellum
Little Drummer Boy	Pentatonix
Anything Could Happen	Ellie Goulding
Where You At	Jennifer Hudson
Already Gone	Kelly Clarkson
My Dawg	Lil Baby
Toothbrush	DNCE
Changed	Rascal Flatts
4AM	Melanie Fiona
Dance for You	Beyonce
Take What You Want	Post Malone Featuring Ozzy Osbourne & Travis Scott
Replay	Zendaya
I Lived	OneRepublic
The London	Young Thug, J. Cole & Travis Scott
Thinkin Bout You	Frank Ocean
Walk Me Home	P!nk
Used to Love You	Gwen Stefani
Better Now	Post Malone
Lifestyle	Rich Gang Featuring Young Thug & Rich Homie Quan
Hold It Against Me	Britney Spears
Million Reasons	Lady Gaga
The Feeling	Justin Bieber Featuring Halsey
Breakthrough	Bridgit Mendler, Adam Hicks, Naomi Scott & Hayley Kiyoko
Murder on My Mind	YNW Melly
One Kiss	Calvin Harris & Dua Lipa
Somebody’s Heartbreak	Hunter Hayes
Roman’s Revenge	Nicki Minaj Featuring Eminem
I’ll Kill You	Summer Walker Featuring Jhene Aiko
Water	Ugly God
Lose It	Kane Brown
Die Young	Ke$ha
H·A·M	Kanye West Jay Z
Blackbird	Glee Cast
No Love	August Alsina
Bandz a Make Her Dance (Remix)	Juicy J Featuring Lil Wayne & 2 Chainz
Dirt On My Boots	Jon Pardi
Juicy	Doja Cat & Tyga
Shining	DJ Khaled Featuring Beyonce & JAY Z
The Hills	The Weeknd
Heartbeat Song	Kelly Clarkson
No Excuses	Meghan Trainor
Summer Days	Martin Garrix Featuring Macklemore & Patrick Stump
Stay the Night	James Blunt
Look At Me!	XXXTENTACION
Power Trip	J. Cole Featuring Miguel
Lil Freak	Usher Featuring Nicki Minaj
The Plan	G-Eazy
Nobody Love	Tori Kelly
Guap	Big Sean
High By The Beach	Lana Del Rey
Save Me, San Francisco	Train
Faded	Alan Walker
Carry On	fun.
There Was This Girl	Riley Green
Lights	Ellie Goulding
Sorry Not Sorry	Demi Lovato
Tell Me You Love Me	Demi Lovato
Sorry Not Sorry	Demi Lovato
Tell Me You Love Me	Demi Lovato
Cold	Maroon 5 Featuring Future
XO TOUR Llif3	Lil Uzi Vert
Head Above Water	Avril Lavigne
John	Lil Wayne Featuring Rick Ross
​​ocean eyes	Billie Eilish
Nothin’ on You	B.o.B Featuring Bruno Mars
El Perdón (Forgiveness)	Nicky Jam & Enrique Iglesias
Half of My Heart	John Mayer
Now or Never	Halsey
Snapback	Old Dominion
Lockjaw	French Montana Featuring Kodak Black
Hopeless Romantic	Wiz Khalifa Featuring Swae Lee
Who You Love	John Mayer Featuring Katy Perry
Meant to Be	Bebe Rexha & Florida Georgia Line
Not Afraid	Eminem
Friends	Justin Bieber + BloodPop
Somebody	Natalie La Rose Featuring Jeremih
When We Were Young	Adele
The Cave	Mumford & Sons
The Only Exception	Paramore
There’s Nothing Holdin’ Me Back	Shawn Mendes
Carolina	Parmalee
Easy	Rascal Flatts Featuring Natasha Bedingfield
We Went	Randy Houser
Hello	Karmin
See You Again	Carrie Underwood
Kiss and Make Up	Dua Lipa & BLACKPINK
Big Rings	Drake & Future
OOOUUU	Young M.A
Girl Like You	Jason Aldean
Tusa	Karol G & Nicki Minaj
Just Like Fire	P!nk
No Frauds	Nicki Minaj, Drake & Lil Wayne
Wherever I Go	OneRepublic
Blow Your Mind (Mwah)	Dua Lipa
Might Be	DJ Luke Nasty
That’s How Country Boys Roll	Billy Currington
T-Shirt	Migos
Wesley’s Theory	Kendrick Lamar Featuring George Clinton & Thundercat
Little Things	One Direction
Don’t Hold Your Breath	Nicole Scherzinger
HUMBLE.	Kendrick Lamar
Dangerous Woman	Ariana Grande
YOSEMITE	Travis Scott
Moves Like Jagger	Maroon 5 Featuring Christina Aguilera
Bittersweet	Fantasia
Later On	The Swon Brothers
Unsteady	X Ambassadors
Before I Let Go	Beyonce
Down	Jay Sean Featuring Lil Wayne
Run This Town	Jay-Z, Rihanna & Kanye West
A Little More Country Than That	Easton Corbin
Landslide	Glee Cast Featuring Gwyneth Paltrow
Liar	Camila Cabello
Jocelyn Flores	XXXTENTACION
Law	Yo Gotti Featuring E-40
Body Like a Back Road	Sam Hunt
Outside	Calvin Harris Featuring Ellie Goulding
Starboy	The Weeknd Featuring Daft Punk
I Can Transform Ya	Chris Brown Featuring Lil Wayne & Swizz Beatz
All In My Head (Flex)	Fifth Harmony Featuring Fetty Wap
Babel	Mumford & Sons
Ain’t Leavin Without You	Jaheim
Want to Want Me	Jason Derulo
The One That Got Away	Jake Owen
Lust	Lil Skies
Gives You Hell	Glee Cast
19 You + Me	Dan + Shay
MOOD 4 EVA	Beyonce, JAY-Z & Childish Gambino Featuring Oumou Sangare
BURN IT DOWN	Linkin Park
Champagne Life	Ne-Yo
Black Widow	Iggy Azalea Featuring Rita Ora
Song for Another Time	Old Dominion
Seein’ Red	Dustin Lynch
Budapest	George Ezra
Someone You Loved	Lewis Capaldi
Shape of You	Ed Sheeran
Say Something	Timbaland Featuring Drake
Chained to the Rhythm	Katy Perry Featuring Skip Marley
Southbound	Carrie Underwood
Patek Water	Future & Young Thug Featuring Offset
Mob Ties	Drake
Never Enough	One Direction
Telephone	Lady Gaga Featuring Beyonce
Bills	LunchMoney Lewis
Envy Me	Calboy
My Songs Know What You Did in the Dark (Light ’Em Up)	Fall Out Boy
Keep the Family Close	Drake
Ima Boss (Remix)	Meek Mill Featuring T.I., Birdman, Lil Wayne, DJ Khaled, Rick Ross & Swizz Beatz
Children	Justin Bieber
Ric Flair Drip	Offset & Metro Boomin
One Call Away	Charlie Puth
Consequences	Camila Cabello
Hollywood’s Bleeding	Post Malone
Or Nah	Ty Dolla $ign Featuring Wiz Khalifa & DJ Mustard
Done.	The Band Perry
Bohemian Rhapsody	Queen
Love Me	Lil Wayne Featuring Drake & Future
​i​ hate u, i love u	gnash Featuring Olivia O'Brien
I Can’t Love You Back	Easton Corbin
Timber	Pitbull Featuring Ke$ha
Undecided	Chris Brown
Acquainted	The Weeknd
Someday	Rob Thomas
Mr. Know It All	Kelly Clarkson
These Walls	Kendrick Lamar Featuring Bilal, Anna Wise & Thundercat
Mine	Bazzi
Rope	Foo Fighters
Right Here	Justin Bieber Featuring Drake
Problem	Ariana Grande Featuring Iggy Azalea
Issues	Julia Michaels
The Time (Dirty Bit)	The Black Eyed Peas
Pumped Up Kicks	Foster The People
STARGAZING	Travis Scott
Heartless	The Weeknd
Crushed Up	Future
Eyes Open	Taylor Swift
Mistletoe	Justin Bieber
V. 3005	Childish Gambino
American Saturday Night	Brad Paisley
Gimmie That Girl	Joe Nichols
One Last Time	Ariana Grande
Wow.	Post Malone
You & Me	Marc E. Bassy Featuring G-Eazy
Praise the Lord (Da Shine)	A$AP Rocky Featuring Skepta
Cool	Jonas Brothers
KOD	J. Cole
Burn Out	Midland
Do You Remember	Jay Sean Featuring Sean Paul & Lil Jon
When I Look at You	Miley Cyrus
Hallelujah	Leonard Cohen
Who Dat Girl	Flo Rida Featuring Akon
Uber Everywhere	MadeinTYO
Get You	Daniel Caesar Featuring Kali Uchis
Noticed	Lil Mosey
Cold Water	Major Lazer Featuring Justin Bieber & MO
